name,team,age,gp,g,fgfreq,fgm,fga,fgp,efgp,2fgfreq,2fgm,2fga,2fgp,3pfreq,3pm,3pa,3pp
DeMar DeRozan,TOR ,28,6,6,100%,9,24,37.5,39.6,79.20%,8,19,42.1,20.80%,1,5,20
Jrue Holiday,NOP ,27,9,7,100%,14,21,66.7,69,95.20%,13,20,65,4.80%,1,1,100
Anthony Davis,NOP ,25,9,7,100%,10,20,50,50,85.00%,10,17,58.8,15.00%,0,3,0
Eric Bledsoe,MIL ,28,6,5,100%,11,19,57.9,68.4,57.90%,7,11,63.6,42.10%,4,8,50
Spencer Dinwiddie,BKN ,25,6,5,100%,5,19,26.3,28.9,42.10%,4,8,50,57.90%,1,11,9.1
DeMarcus Cousins,NOP ,27,6,6,100%,6,16,37.5,37.5,62.50%,6,10,60,37.50%,0,6,0
Kyle Kuzma,LAL ,22,7,7,100%,6,16,37.5,46.9,50.00%,3,8,37.5,50.00%,3,8,37.5
Jimmy Butler,MIN ,28,5,5,100%,8,15,53.3,63.3,73.30%,5,11,45.5,26.70%,3,4,75
Bradley Beal,WAS ,24,6,6,100%,5,14,35.7,39.3,64.30%,4,9,44.4,35.70%,1,5,20
Dwyane Wade,MIA ,36,5,5,100%,5,13,38.5,38.5,92.30%,5,12,41.7,7.70%,0,1,0
Russell Westbrook,OKC ,29,4,4,100%,5,13,38.5,38.5,69.20%,5,9,55.6,30.80%,0,4,0
Kelly Olynyk,MIA ,27,8,7,100%,4,13,30.8,38.5,46.20%,2,6,33.3,53.80%,2,7,28.6
Kemba Walker,CHA ,28,4,4,100%,8,12,66.7,91.7,41.70%,2,5,40,58.30%,6,7,85.7
James Johnson,MIA ,31,7,5,100%,9,11,81.8,86.4,81.80%,8,9,88.9,18.20%,1,2,50
Will Barton,DEN ,27,7,5,100%,8,11,72.7,90.9,45.50%,4,5,80,54.50%,4,6,66.7
John Wall,WAS ,27,3,3,100%,6,10,60,60,70.00%,6,7,85.7,30.00%,0,3,0
Kyrie Irving,BOS ,26,3,3,100%,6,10,60,60,80.00%,6,8,75,20.00%,0,2,0
Josh Richardson,MIA ,24,8,5,100%,5,10,50,50,80.00%,5,8,62.5,20.00%,0,2,0
Kristaps Porzingis,NYK ,22,4,3,100%,4,10,40,50,40.00%,2,4,50,60.00%,2,6,33.3
Kentavious Caldwell-Pope,LAL ,25,6,5,100%,4,10,40,50,30.00%,2,3,66.7,70.00%,2,7,28.6
Donovan Mitchell,UTA ,21,3,3,100%,3,10,30,40,20.00%,1,2,50,80.00%,2,8,25
Ish Smith,DET ,29,4,4,100%,2,10,20,25,50.00%,1,5,20,50.00%,1,5,20
Lonzo Ball,LAL ,20,5,4,100%,5,9,55.6,61.1,55.60%,4,5,80,44.40%,1,4,25
Goran Dragic,MIA ,32,8,5,100%,5,9,55.6,66.7,55.60%,3,5,60,44.40%,2,4,50
Nikola Jokic,DEN ,23,6,5,100%,4,9,44.4,55.6,55.60%,2,5,40,44.40%,2,4,50
Kris Dunn,CHI ,24,3,3,100%,3,9,33.3,33.3,88.90%,3,8,37.5,11.10%,0,1,0
Khris Middleton,MIL ,26,6,6,100%,3,9,33.3,38.9,66.70%,2,6,33.3,33.30%,1,3,33.3
Giannis Antetokounmpo,MIL ,23,4,4,100%,3,9,33.3,33.3,77.80%,3,7,42.9,22.20%,0,2,0
Otto Porter Jr.,WAS ,24,5,4,100%,2,9,22.2,33.3,33.30%,0,3,0,66.70%,2,6,33.3
Yogi Ferrell,DAL ,25,4,4,100%,2,9,22.2,22.2,33.30%,2,3,66.7,66.70%,0,6,0
Lauri Markkanen,CHI ,21,5,5,100%,5,8,62.5,75,37.50%,3,3,100,62.50%,2,5,40
Andre Drummond,DET ,24,5,4,100%,5,8,62.5,62.5,87.50%,5,7,71.4,12.50%,0,1,0
CJ McCollum,POR ,26,3,3,100%,4,8,50,50,87.50%,4,7,57.1,12.50%,0,1,0
Blake Griffin,DET ,29,4,4,100%,3,8,37.5,50,25.00%,1,2,50,75.00%,2,6,33.3
Harrison Barnes,DAL ,25,4,4,100%,2,8,25,25,62.50%,2,5,40,37.50%,0,3,0
Kevin Durant,GSW ,29,2,2,100%,6,7,85.7,100,57.10%,4,4,100,42.90%,2,3,66.7
Dennis Smith Jr.,DAL ,20,4,3,100%,4,7,57.1,64.3,71.40%,3,5,60,28.60%,1,2,50
Zach Randolph,SAC ,36,2,2,100%,3,7,42.9,57.1,42.90%,1,3,33.3,57.10%,2,4,50
Allen Crabbe,BKN ,26,6,4,100%,3,7,42.9,64.3,28.60%,0,2,0,71.40%,3,5,60
Fred VanVleet,TOR ,24,5,3,100%,3,7,42.9,57.1,42.90%,1,3,33.3,57.10%,2,4,50
Nikola Mirotic,NOP ,27,5,3,100%,3,7,42.9,50,42.90%,2,3,66.7,57.10%,1,4,25
Jamal Murray,DEN ,21,6,5,100%,3,7,42.9,50,57.10%,2,4,50,42.90%,1,3,33.3
Dion Waiters,MIA ,26,1,1,100%,3,7,42.9,50,57.10%,2,4,50,42.90%,1,3,33.3
Karl-Anthony Towns,MIN ,22,4,3,100%,2,7,28.6,35.7,71.40%,1,5,20,28.60%,1,2,50
Kyle Lowry,TOR ,32,5,4,100%,2,7,28.6,35.7,42.90%,1,3,33.3,57.10%,1,4,25
LeBron James,CLE ,33,2,2,100%,5,6,83.3,91.7,66.70%,4,4,100,33.30%,1,2,50
Michael Beasley,NYK ,29,4,3,100%,5,6,83.3,83.3,100%,5,6,83.3,0.00%,0,0,-
Jaylen Brown,BOS ,21,3,3,100%,4,6,66.7,75,66.70%,3,4,75,33.30%,1,2,50
Josh Hart,LAL ,23,5,2,100%,4,6,66.7,75,50.00%,3,3,100,50.00%,1,3,33.3
Jordan Clarkson,CLE ,25,2,2,100%,4,6,66.7,83.3,33.30%,2,2,100,66.70%,2,4,50
Marcin Gortat,WAS ,34,6,3,100%,3,6,50,50,100%,3,6,50,0.00%,0,0,-
Jeff Teague,MIN ,29,4,3,100%,3,6,50,58.3,50.00%,2,3,66.7,50.00%,1,3,33.3
Brandon Ingram,LAL ,20,6,3,100%,3,6,50,50,100%,3,6,50,0.00%,0,0,-
Chris Paul,HOU ,33,1,1,100%,3,6,50,58.3,66.70%,2,4,50,33.30%,1,2,50
Patty Mills,SAS ,29,2,2,100%,3,6,50,50,66.70%,3,4,75,33.30%,0,2,0
Damian Lillard,POR ,27,2,2,100%,3,6,50,58.3,50.00%,2,3,66.7,50.00%,1,3,33.3
Serge Ibaka,TOR ,28,4,3,100%,2,6,33.3,33.3,50.00%,2,3,66.7,50.00%,0,3,0
Robin Lopez,CHI ,30,5,4,100%,2,6,33.3,33.3,100%,2,6,33.3,0.00%,0,0,-
Carmelo Anthony,OKC ,33,4,3,100%,2,6,33.3,41.7,83.30%,1,5,20,16.70%,1,1,100
Justin Holiday,CHI ,29,5,4,100%,1,6,16.7,16.7,16.70%,1,1,100,83.30%,0,5,0
Reggie Bullock,DET ,27,3,3,100%,0,6,0,0,33.30%,0,2,0,66.70%,0,4,0
Joel Embiid,PHI ,24,2,2,100%,4,5,80,90,80.00%,3,4,75,20.00%,1,1,100
Darren Collison,IND ,30,2,2,100%,4,5,80,100,60.00%,2,3,66.7,40.00%,2,2,100
Victor Oladipo,IND ,26,3,3,100%,3,5,60,80,40.00%,1,2,50,60.00%,2,3,66.7
De'Aaron Fox,SAC ,20,3,2,100%,3,5,60,60,100%,3,5,60,0.00%,0,0,-
Andrew Wiggins,MIN ,23,5,3,100%,3,5,60,70,40.00%,2,2,100,60.00%,1,3,33.3
Rondae Hollis-Jefferson,BKN ,23,4,3,100%,3,5,60,60,100%,3,5,60,0.00%,0,0,-
Jabari Parker,MIL ,23,2,1,100%,3,5,60,70,40.00%,2,2,100,60.00%,1,3,33.3
Caris LeVert,BKN ,23,4,3,100%,2,5,40,40,60.00%,2,3,66.7,40.00%,0,2,0
Delon Wright,TOR ,26,3,3,100%,2,5,40,50,60.00%,1,3,33.3,40.00%,1,2,50
DeMarre Carroll,BKN ,31,5,2,100%,2,5,40,50,40.00%,1,2,50,60.00%,1,3,33.3
Jarrett Jack,NYK ,34,4,3,100%,2,5,40,40,80.00%,2,4,50,20.00%,0,1,0
Jeremy Lamb,CHA ,25,3,2,100%,2,5,40,40,60.00%,2,3,66.7,40.00%,0,2,0
E'Twaun Moore,NOP ,29,9,4,100%,1,5,20,20,60.00%,1,3,33.3,40.00%,0,2,0
Gary Harris,DEN ,23,3,3,100%,1,5,20,30,20.00%,0,1,0,80.00%,1,4,25
Courtney Lee,NYK ,32,5,3,100%,0,5,0,0,60.00%,0,3,0,40.00%,0,2,0
Wilson Chandler,DEN ,31,4,2,100%,0,5,0,0,40.00%,0,2,0,60.00%,0,3,0
Dwight Howard,CHA ,32,4,2,100%,3,4,75,75,75.00%,3,3,100,25.00%,0,1,0
Julius Randle,LAL ,23,7,3,100%,3,4,75,75,100%,3,4,75,0.00%,0,0,-
Evan Fournier,ORL ,25,2,2,100%,3,4,75,87.5,50.00%,2,2,100,50.00%,1,2,50
Thaddeus Young,IND ,29,3,3,100%,3,4,75,75,100%,3,4,75,0.00%,0,0,-
Paul Millsap,DEN ,33,4,2,100%,3,4,75,75,100%,3,4,75,0.00%,0,0,-
Trey Burke,NYK ,25,1,1,100%,3,4,75,75,75.00%,3,3,100,25.00%,0,1,0
Doug McDermott,DAL ,26,5,1,100%,2,4,50,50,100%,2,4,50,0.00%,0,0,-
Joe Ingles,UTA ,30,3,2,100%,2,4,50,75,0.00%,0,0,-,100%,2,4,50
Wayne Ellington,MIA ,30,5,3,100%,2,4,50,62.5,25.00%,1,1,100,75.00%,1,3,33.3
Marvin Williams,CHA ,31,3,3,100%,2,4,50,50,50.00%,2,2,100,50.00%,0,2,0
Marcus Morris,BOS ,28,3,2,100%,2,4,50,50,75.00%,2,3,66.7,25.00%,0,1,0
J.J. Barea,DAL ,33,2,2,100%,1,4,25,25,50.00%,1,2,50,50.00%,0,2,0
JR Smith,CLE ,32,2,2,100%,1,4,25,25,25.00%,1,1,100,75.00%,0,3,0
Terry Rozier,BOS ,24,3,1,100%,1,4,25,37.5,25.00%,0,1,0,75.00%,1,3,33.3
Paul George,OKC ,28,3,3,100%,1,4,25,37.5,50.00%,0,2,0,50.00%,1,2,50
Lou Williams,LAC ,31,1,1,100%,1,4,25,25,50.00%,1,2,50,50.00%,0,2,0
Markieff Morris,WAS ,28,5,2,100%,1,4,25,37.5,50.00%,0,2,0,50.00%,1,2,50
Darius Miller,NOP ,28,4,4,100%,0,4,0,0,0.00%,0,0,-,100%,0,4,0
Nicolas Batum,CHA ,29,2,2,100%,0,4,0,0,25.00%,0,1,0,75.00%,0,3,0
Devin Booker,PHX ,21,1,1,100%,0,4,0,0,100%,0,4,0,0.00%,0,0,-
Stephen Curry,GSW ,30,1,1,100%,3,3,100,133.3,33.30%,1,1,100,66.70%,2,2,100
Bogdan Bogdanovic,SAC ,25,2,2,100%,3,3,100,133.3,33.30%,1,1,100,66.70%,2,2,100
Maurice Harkless,POR ,25,2,2,100%,3,3,100,100,100%,3,3,100,0.00%,0,0,-
Tyreke Evans,MEM ,28,1,1,100%,3,3,100,116.7,66.70%,2,2,100,33.30%,1,1,100
Reggie Jackson,DET ,28,1,1,100%,3,3,100,100,100%,3,3,100,0.00%,0,0,-
Alex Abrines,OKC ,24,3,2,100%,3,3,100,150,0.00%,0,0,-,100%,3,3,100
Trey Lyles,DEN ,22,4,1,100%,2,3,66.7,66.7,66.70%,2,2,100,33.30%,0,1,0
Jameer Nelson,DET ,36,2,2,100%,2,3,66.7,83.3,33.30%,1,1,100,66.70%,1,2,50
Myles Turner,IND ,22,3,2,100%,2,3,66.7,66.7,100%,2,3,66.7,0.00%,0,0,-
James Harden,HOU ,28,1,1,100%,2,3,66.7,66.7,100%,2,3,66.7,0.00%,0,0,-
Frank Mason,SAC ,24,1,1,100%,2,3,66.7,66.7,66.70%,2,2,100,33.30%,0,1,0
Dennis Schroder,ATL ,24,1,1,100%,2,3,66.7,66.7,100%,2,3,66.7,0.00%,0,0,-
Nikola Vucevic,ORL ,27,2,2,100%,1,3,33.3,33.3,33.30%,1,1,100,66.70%,0,2,0
Jayson Tatum,BOS ,20,4,2,100%,1,3,33.3,33.3,100%,1,3,33.3,0.00%,0,0,-
JJ Redick,PHI ,33,2,1,100%,1,3,33.3,33.3,33.30%,1,1,100,66.70%,0,2,0
LaMarcus Aldridge,SAS ,32,2,1,100%,1,3,33.3,33.3,100%,1,3,33.3,0.00%,0,0,-
Bojan Bogdanovic,IND ,29,3,3,100%,1,3,33.3,50,0.00%,0,0,-,100%,1,3,33.3
Jonathon Simmons,ORL ,28,1,1,100%,1,3,33.3,33.3,66.70%,1,2,50,33.30%,0,1,0
Marcus Smart,BOS ,24,2,2,100%,1,3,33.3,33.3,33.30%,1,1,100,66.70%,0,2,0
Al-Farouq Aminu,POR ,27,2,1,100%,1,3,33.3,50,66.70%,0,2,0,33.30%,1,1,100
Danny Green,SAS ,30,2,1,100%,0,3,0,0,33.30%,0,1,0,66.70%,0,2,0
Joe Johnson,HOU ,36,2,2,100%,0,3,0,0,0.00%,0,0,-,100%,0,3,0
Eric Gordon,HOU ,29,2,2,100%,0,3,0,0,33.30%,0,1,0,66.70%,0,2,0
Wesley Matthews,DAL ,31,3,2,100%,0,3,0,0,0.00%,0,0,-,100%,0,3,0
Denzel Valentine,CHI ,24,4,3,100%,0,3,0,0,33.30%,0,1,0,66.70%,0,2,0
Tobias Harris,LAC ,25,1,1,100%,0,3,0,0,66.70%,0,2,0,33.30%,0,1,0
Kevin Love,CLE ,29,1,1,100%,2,2,100,150,0.00%,0,0,-,100%,2,2,100
Johnathan Motley,DAL ,23,1,1,100%,2,2,100,100,100%,2,2,100,0.00%,0,0,-
Joe Harris,BKN ,26,4,2,100%,2,2,100,100,100%,2,2,100,0.00%,0,0,-
Rajon Rondo,NOP ,32,4,1,100%,2,2,100,125,50.00%,1,1,100,50.00%,1,1,100
Justise Winslow,MIA ,22,7,2,100%,2,2,100,100,100%,2,2,100,0.00%,0,0,-
DeAndre Jordan,LAC ,29,1,1,100%,2,2,100,100,100%,2,2,100,0.00%,0,0,-
Ricky Rubio,UTA ,27,3,1,100%,2,2,100,125,50.00%,1,1,100,50.00%,1,1,100
Elfrid Payton,PHX ,24,1,1,100%,1,2,50,50,50.00%,1,1,100,50.00%,0,1,0
Rudy Gay,SAS ,31,2,1,100%,1,2,50,50,100%,1,2,50,0.00%,0,0,-
Cedi Osman,CLE ,23,2,1,100%,1,2,50,50,50.00%,1,1,100,50.00%,0,1,0
Lance Thomas,NYK ,30,2,1,100%,1,2,50,75,0.00%,0,0,-,100%,1,2,50
D'Angelo Russell,BKN ,22,1,1,100%,1,2,50,75,0.00%,0,0,-,100%,1,2,50
Robert Covington,PHI ,27,1,1,100%,1,2,50,50,50.00%,1,1,100,50.00%,0,1,0
Evan Turner,POR ,29,2,2,100%,1,2,50,75,0.00%,0,0,-,100%,1,2,50
TJ Warren,PHX ,24,1,1,100%,1,2,50,50,100%,1,2,50,0.00%,0,0,-
Jonas Valanciunas,TOR ,26,3,2,100%,1,2,50,50,50.00%,1,1,100,50.00%,0,1,0
Dejounte Murray,SAS ,21,2,1,100%,1,2,50,50,100%,1,2,50,0.00%,0,0,-
Buddy Hield,SAC ,24,3,1,100%,1,2,50,75,50.00%,0,1,0,50.00%,1,1,100
Ben Simmons,PHI ,21,2,1,100%,1,2,50,50,100%,1,2,50,0.00%,0,0,-
PJ Tucker,HOU ,33,2,1,100%,1,2,50,50,50.00%,1,1,100,50.00%,0,1,0
Taurean Prince,ATL ,24,1,1,100%,1,2,50,75,0.00%,0,0,-,100%,1,2,50
Aaron Gordon,ORL ,22,2,2,100%,1,2,50,50,50.00%,1,1,100,50.00%,0,1,0
DeAndre Liggins,NOP ,30,2,1,100%,1,2,50,50,50.00%,1,1,100,50.00%,0,1,0
Corey Brewer,OKC ,32,2,1,100%,1,2,50,75,0.00%,0,0,-,100%,1,2,50
Michael Kidd-Gilchrist,CHA ,24,3,2,100%,1,2,50,50,100%,1,2,50,0.00%,0,0,-
Jakob Poeltl,TOR ,22,1,1,100%,1,2,50,50,100%,1,2,50,0.00%,0,0,-
Rudy Gobert,UTA ,25,3,2,100%,1,2,50,50,100%,1,2,50,0.00%,0,0,-
Marco Belinelli,PHI ,32,1,1,100%,1,2,50,75,0.00%,0,0,-,100%,1,2,50
Tim Hardaway Jr.,NYK ,26,2,2,100%,1,2,50,75,0.00%,0,0,-,100%,1,2,50
Marc Gasol,MEM ,33,1,1,100%,1,2,50,50,100%,1,2,50,0.00%,0,0,-
Jusuf Nurkic,POR ,23,3,1,100%,0,2,0,0,50.00%,0,1,0,50.00%,0,1,0
Aaron Harrison,DAL ,23,1,1,100%,0,2,0,0,0.00%,0,0,-,100%,0,2,0
Malcolm Brogdon,MIL ,25,2,2,100%,0,2,0,0,50.00%,0,1,0,50.00%,0,1,0
Tomas Satoransky,WAS ,26,3,1,100%,0,2,0,0,100%,0,2,0,0.00%,0,0,-
Tony Snell,MIL ,26,4,2,100%,0,2,0,0,0.00%,0,0,-,100%,0,2,0
Manu Ginobili,SAS ,40,1,1,100%,0,2,0,0,50.00%,0,1,0,50.00%,0,1,0
Dirk Nowitzki,DAL ,39,2,1,100%,0,2,0,0,100%,0,2,0,0.00%,0,0,-
Andre Iguodala,GSW ,34,2,1,100%,1,1,100,100,100%,1,1,100,0.00%,0,0,-
Jamal Crawford,MIN ,38,4,1,100%,1,1,100,100,100%,1,1,100,0.00%,0,0,-
Enes Kanter,NYK ,26,1,1,100%,1,1,100,100,100%,1,1,100,0.00%,0,0,-
Al Horford,BOS ,31,3,1,100%,1,1,100,150,0.00%,0,0,-,100%,1,1,100
David Nwaba,CHI ,25,3,1,100%,1,1,100,100,100%,1,1,100,0.00%,0,0,-
Kenneth Faried,DEN ,28,1,1,100%,1,1,100,100,100%,1,1,100,0.00%,0,0,-
Langston Galloway,DET ,26,2,1,100%,1,1,100,150,0.00%,0,0,-,100%,1,1,100
Bam Adebayo,MIA ,20,6,1,100%,1,1,100,100,100%,1,1,100,0.00%,0,0,-
D.J. Augustin,ORL ,30,2,1,100%,1,1,100,100,100%,1,1,100,0.00%,0,0,-
Steven Adams,OKC ,24,4,1,100%,1,1,100,100,100%,1,1,100,0.00%,0,0,-
Jerian Grant,CHI ,25,2,1,100%,1,1,100,100,100%,1,1,100,0.00%,0,0,-
Larry Nance Jr.,CLE ,25,1,1,100%,1,1,100,100,100%,1,1,100,0.00%,0,0,-
Torrey Craig,DEN ,27,3,1,100%,1,1,100,150,0.00%,0,0,-,100%,1,1,100
Pascal Siakam,TOR ,24,5,1,100%,1,1,100,100,100%,1,1,100,0.00%,0,0,-
Tarik Black,HOU ,26,1,1,100%,1,1,100,100,100%,1,1,100,0.00%,0,0,-
Gerald Green,HOU ,32,1,1,100%,1,1,100,100,100%,1,1,100,0.00%,0,0,-
Jason Terry,MIL ,40,4,1,100%,1,1,100,150,0.00%,0,0,-,100%,1,1,100
Tyler Johnson,MIA ,26,6,1,100%,1,1,100,100,100%,1,1,100,0.00%,0,0,-
Dwight Powell,DAL ,26,4,1,100%,1,1,100,150,0.00%,0,0,-,100%,1,1,100
JaMychal Green,MEM ,27,1,1,100%,0,1,0,0,100%,0,1,0,0.00%,0,0,-
Austin Rivers,LAC ,25,1,1,100%,0,1,0,0,0.00%,0,0,-,100%,0,1,0
Malik Monk,CHA ,20,1,1,100%,0,1,0,0,0.00%,0,0,-,100%,0,1,0
Luke Kornet,NYK ,22,1,1,100%,0,1,0,0,100%,0,1,0,0.00%,0,0,-
Kyle Collinsworth,DAL ,26,1,1,100%,0,1,0,0,100%,0,1,0,0.00%,0,0,-
Jalen Jones,DAL ,25,1,1,100%,0,1,0,0,0.00%,0,0,-,100%,0,1,0
Ersan Ilyasova,PHI ,31,1,1,100%,0,1,0,0,0.00%,0,0,-,100%,0,1,0
Stanley Johnson,DET ,21,3,1,100%,0,1,0,0,0.00%,0,0,-,100%,0,1,0
Draymond Green,GSW ,28,1,1,100%,0,1,0,0,100%,0,1,0,0.00%,0,0,-
Vince Carter,SAC ,41,1,1,100%,0,1,0,0,100%,0,1,0,0.00%,0,0,-
Frank Ntilikina,NYK ,19,1,1,100%,0,1,0,0,100%,0,1,0,0.00%,0,0,-
Tristan Thompson,CLE ,27,1,1,100%,0,1,0,0,100%,0,1,0,0.00%,0,0,-
CJ Miles,TOR ,31,5,1,100%,0,1,0,0,0.00%,0,0,-,100%,0,1,0
Dorian Finney-Smith,DAL ,25,1,1,100%,0,1,0,0,100%,0,1,0,0.00%,0,0,-
Willie Cauley-Stein,SAC ,24,2,1,100%,0,1,0,0,100%,0,1,0,0.00%,0,0,-
Kyle O'Quinn,NYK ,28,1,1,100%,0,1,0,0,100%,0,1,0,0.00%,0,0,-
Luke Kennard,DET ,21,3,1,100%,0,1,0,0,0.00%,0,0,-,100%,0,1,0
Ian Clark,NOP ,27,5,1,100%,0,1,0,0,0.00%,0,0,-,100%,0,1,0
Shabazz Napier,POR ,26,1,1,100%,0,1,0,0,100%,0,1,0,0.00%,0,0,-
Frank Kaminsky,CHA ,25,2,1,100%,0,1,0,0,0.00%,0,0,-,100%,0,1,0
Dario Saric,PHI ,24,2,1,100%,0,1,0,0,0.00%,0,0,-,100%,0,1,0
Anthony Tolliver,DET ,32,3,1,100%,0,1,0,0,0.00%,0,0,-,100%,0,1,0
Devin Harris,DEN ,35,3,1,100%,0,1,0,0,0.00%,0,0,-,100%,0,1,0
John Henson,MIL ,27,3,1,100%,0,1,0,0,0.00%,0,0,-,100%,0,1,0
Clint Capela,HOU ,24,1,1,100%,0,1,0,0,100%,0,1,0,0.00%,0,0,-
Klay Thompson,GSW ,28,2,1,100%,0,1,0,0,0.00%,0,0,-,100%,0,1,0
Tyler Ennis,LAL ,23,2,1,100%,0,1,0,0,100%,0,1,0,0.00%,0,0,-
Kent Bazemore,ATL ,28,1,1,100%,0,1,0,0,100%,0,1,0,0.00%,0,0,-
Kelly Oubre Jr.,WAS ,22,4,1,100%,0,1,0,0,0.00%,0,0,-,100%,0,1,0
