name,team,age,gp,g,fgfreq,fgm,fga,fgp,efgp,2fgfreq,2fgm,2fga,2fgp,3pfreq,3pm,3pa,3pp
Tobias Harris,LAC ,25,80,80,100%,219,444,49.3,58.4,60.10%,138,267,51.7,39.90%,81,177,45.8
LeBron James,CLE ,33,82,82,100%,264,434,60.8,64.2,82.70%,235,359,65.5,17.30%,29,75,38.7
Anthony Davis,NOP ,25,74,73,100%,235,421,55.8,57.5,92.40%,221,389,56.8,7.60%,14,32,43.8
Andrew Wiggins,MIN ,23,82,82,100%,199,414,48.1,51.9,76.30%,167,316,52.8,23.70%,32,98,32.7
DeMar DeRozan,TOR ,28,80,80,100%,191,394,48.5,51.8,75.90%,165,299,55.2,24.10%,26,95,27.4
Bradley Beal,WAS ,24,82,82,100%,183,385,47.5,53.9,64.20%,134,247,54.3,35.80%,49,138,35.5
James Harden,HOU ,28,72,72,100%,200,383,52.2,62.7,49.30%,120,189,63.5,50.70%,80,194,41.2
Russell Westbrook,OKC ,29,78,78,100%,177,383,46.2,47.5,91.60%,167,351,47.6,8.40%,10,32,31.3
LaMarcus Aldridge,SAS ,32,75,75,100%,214,379,56.5,59,89.70%,195,340,57.4,10.30%,19,39,48.7
Damian Lillard,POR ,27,73,72,100%,168,375,44.8,54.4,46.70%,96,175,54.9,53.30%,72,200,36
Khris Middleton,MIL ,26,81,81,100%,184,374,49.2,54.3,71.70%,146,268,54.5,28.30%,38,106,35.8
Paul George,OKC ,28,78,78,100%,186,361,51.5,62.5,55.70%,107,201,53.2,44.30%,79,160,49.4
Harrison Barnes,DAL ,25,77,77,100%,170,358,47.5,52.8,71.80%,132,257,51.4,28.20%,38,101,37.6
Kevin Durant,GSW ,29,68,66,100%,194,348,55.7,61.9,71.00%,151,247,61.1,29.00%,43,101,42.6
Carmelo Anthony,OKC ,33,76,76,100%,152,337,45.1,52.4,62.60%,103,211,48.8,37.40%,49,126,38.9
Dwight Howard,CHA ,32,81,80,100%,206,333,61.9,61.9,100%,206,333,61.9,0.00%,0,0,-
CJ McCollum,POR ,26,81,80,100%,162,333,48.6,57.1,63.10%,106,210,50.5,36.90%,56,123,45.5
Giannis Antetokounmpo,MIL ,23,74,74,100%,185,332,55.7,58,89.20%,170,296,57.4,10.80%,15,36,41.7
Jrue Holiday,NOP ,27,80,80,100%,159,322,49.4,54.5,72.40%,126,233,54.1,27.60%,33,89,37.1
Donovan Mitchell,UTA ,21,79,79,100%,147,322,45.7,53.9,53.70%,94,173,54.3,46.30%,53,149,35.6
Victor Oladipo,IND ,26,74,74,100%,162,315,51.4,57.9,71.70%,121,226,53.5,28.30%,41,89,46.1
Kemba Walker,CHA ,28,80,79,100%,150,315,47.6,57.9,51.70%,85,163,52.1,48.30%,65,152,42.8
Marc Gasol,MEM ,33,73,72,100%,149,313,47.6,51.9,76.00%,122,238,51.3,24.00%,27,75,36
Aaron Gordon,ORL ,22,58,57,100%,145,304,47.7,54.4,60.90%,104,185,56.2,39.10%,41,119,34.5
Goran Dragic,MIA ,32,74,73,100%,156,301,51.8,57.5,71.40%,122,215,56.7,28.60%,34,86,39.5
Blake Griffin,DET ,29,58,58,100%,142,299,47.5,53.3,67.90%,107,203,52.7,32.10%,35,96,36.5
Brook Lopez,LAL ,30,73,73,100%,145,298,48.7,56.5,57.40%,98,171,57.3,42.60%,47,127,37
Jusuf Nurkic,POR ,23,79,77,100%,162,297,54.5,54.5,98.70%,162,293,55.3,1.30%,0,4,0
Klay Thompson,GSW ,28,73,72,100%,154,297,51.9,61.8,55.20%,95,164,57.9,44.80%,59,133,44.4
Stephen Curry,GSW ,30,51,51,100%,131,291,45,55.3,42.60%,71,124,57.3,57.40%,60,167,35.9
Otto Porter Jr.,WAS ,24,77,76,100%,150,287,52.3,59.4,67.20%,109,193,56.5,32.80%,41,94,43.6
Robin Lopez,CHI ,30,64,64,100%,164,283,58,58.5,96.80%,161,274,58.8,3.20%,3,9,33.3
Julius Randle,LAL ,23,78,75,100%,177,282,62.8,63.3,95.40%,174,269,64.7,4.60%,3,13,23.1
Justin Holiday,CHI ,29,72,70,100%,111,281,39.5,50.4,41.30%,50,116,43.1,58.70%,61,165,37
Ben Simmons,PHI ,21,80,79,100%,164,280,58.6,58.6,100%,164,280,58.6,0.00%,0,0,-
Dennis Schroder,ATL ,24,66,66,100%,132,280,47.1,50.7,73.20%,112,205,54.6,26.80%,20,75,26.7
Kristaps Porzingis,NYK ,22,48,48,100%,135,279,48.4,52.9,76.30%,110,213,51.6,23.70%,25,66,37.9
Nikola Vucevic,ORL ,27,57,56,100%,138,278,49.6,53.2,78.10%,118,217,54.4,21.90%,20,61,32.8
Joel Embiid,PHI ,24,62,62,100%,141,277,50.9,55.8,74.00%,114,205,55.6,26.00%,27,72,37.5
Taj Gibson,MIN ,32,82,81,100%,174,276,63,63.8,94.90%,170,262,64.9,5.10%,4,14,28.6
Kyrie Irving,BOS ,26,57,57,100%,153,276,55.4,64.3,61.20%,104,169,61.5,38.80%,49,107,45.8
Serge Ibaka,TOR ,28,76,75,100%,143,275,52,59.3,58.20%,103,160,64.4,41.80%,40,115,34.8
Karl-Anthony Towns,MIN ,22,82,78,100%,147,274,53.6,58,77.00%,123,211,58.3,23.00%,24,63,38.1
Jaylen Brown,BOS ,21,67,66,100%,143,267,53.6,61.8,62.90%,99,168,58.9,37.10%,44,99,44.4
TJ Warren,PHX ,24,65,65,100%,132,267,49.4,50,93.60%,129,250,51.6,6.40%,3,17,17.6
Taurean Prince,ATL ,24,81,80,100%,117,267,43.8,53.4,49.80%,66,133,49.6,50.20%,51,134,38.1
Jamal Murray,DEN ,21,80,76,100%,137,266,51.5,61.7,52.60%,83,140,59.3,47.40%,54,126,42.9
Jonas Valanciunas,TOR ,26,77,73,100%,157,265,59.2,62.8,85.30%,138,226,61.1,14.70%,19,39,48.7
Devin Booker,PHX ,21,54,54,100%,126,264,47.7,56.3,61.00%,81,161,50.3,39.00%,45,103,43.7
Evan Fournier,ORL ,25,57,55,100%,141,263,53.6,61.2,64.30%,101,169,59.8,35.70%,40,94,42.6
Gary Harris,DEN ,23,66,65,100%,141,260,54.2,64.6,55.80%,87,145,60,44.20%,54,115,47
Dennis Smith Jr.,DAL ,20,69,69,100%,112,259,43.2,49.4,62.20%,80,161,49.7,37.80%,32,98,32.7
Zach Randolph,SAC ,36,59,59,100%,124,254,48.8,52.6,79.90%,105,203,51.7,20.10%,19,51,37.3
Kevin Love,CLE ,29,59,57,100%,123,254,48.4,58.5,54.70%,72,139,51.8,45.30%,51,115,44.3
Steven Adams,OKC ,24,75,72,100%,178,252,70.6,70.6,100%,178,252,70.6,0.00%,0,0,-
Will Barton,DEN ,27,80,72,100%,131,248,52.8,62.9,52.80%,81,131,61.8,47.20%,50,117,42.7
Thaddeus Young,IND ,29,80,77,100%,129,247,52.2,56.5,77.70%,108,192,56.3,22.30%,21,55,38.2
Nikola Jokic,DEN ,23,74,66,100%,130,245,53.1,57.1,78.40%,110,192,57.3,21.60%,20,53,37.7
Lauri Markkanen,CHI ,21,68,67,100%,117,243,48.1,58.8,48.60%,65,118,55.1,51.40%,52,125,41.6
Ricky Rubio,UTA ,27,77,75,100%,108,242,44.6,50.8,66.50%,78,161,48.4,33.50%,30,81,37
Andre Drummond,DET ,24,78,77,100%,137,241,56.8,56.8,98.80%,137,238,57.6,1.20%,0,3,0
Enes Kanter,NYK ,26,70,67,100%,162,240,67.5,67.5,100%,162,240,67.5,0.00%,0,0,-
Dario Saric,PHI ,24,77,73,100%,129,238,54.2,62.8,58.00%,88,138,63.8,42.00%,41,100,41
Kyle Lowry,TOR ,32,78,78,100%,115,237,48.5,62.4,31.60%,49,75,65.3,68.40%,66,162,40.7
Josh Richardson,MIA ,24,80,80,100%,114,233,48.9,58.2,57.90%,71,135,52.6,42.10%,43,98,43.9
Markieff Morris,WAS ,28,73,71,100%,118,232,50.9,56.3,72.00%,93,167,55.7,28.00%,25,65,38.5
Tim Hardaway Jr.,NYK ,26,57,55,100%,99,232,42.7,48.7,51.70%,71,120,59.2,48.30%,28,112,25
Allen Crabbe,BKN ,26,73,71,100%,100,230,43.5,55.7,38.70%,44,89,49.4,61.30%,56,141,39.7
Lou Williams,LAC ,31,79,74,100%,92,230,40,47.2,63.50%,59,146,40.4,36.50%,33,84,39.3
Courtney Lee,NYK ,32,75,71,100%,118,229,51.5,59.4,65.90%,82,151,54.3,34.10%,36,78,46.2
JJ Redick,PHI ,33,69,68,100%,106,229,46.3,56.3,50.20%,60,115,52.2,49.80%,46,114,40.4
Josh Jackson,PHX ,21,76,67,100%,106,226,46.9,50,77.90%,92,176,52.3,22.10%,14,50,28
Jeff Teague,MIN ,29,70,68,100%,102,225,45.3,50,68.40%,81,154,52.6,31.60%,21,71,29.6
Eric Bledsoe,MIL ,28,74,71,100%,107,224,47.8,54.2,66.10%,78,148,52.7,33.90%,29,76,38.2
Brandon Ingram,LAL ,20,59,58,100%,106,222,47.7,50.9,85.10%,92,189,48.7,14.90%,14,33,42.4
Austin Rivers,LAC ,25,61,60,100%,94,222,42.3,51.6,46.40%,53,103,51.5,53.60%,41,119,34.5
Myles Turner,IND ,22,64,63,100%,109,221,49.3,55.4,72.90%,82,161,50.9,27.10%,27,60,45
Nicolas Batum,CHA ,29,64,64,100%,91,221,41.2,46.4,59.70%,68,132,51.5,40.30%,23,89,25.8
Bojan Bogdanovic,IND ,29,79,78,100%,112,220,50.9,58.2,61.40%,80,135,59.3,38.60%,32,85,37.6
Kentavious Caldwell-Pope,LAL ,25,73,69,100%,101,219,46.1,55.5,49.80%,60,109,55,50.20%,41,110,37.3
Derrick Favors,UTA ,26,77,73,100%,123,215,57.2,58.4,90.20%,118,194,60.8,9.80%,5,21,23.8
E'Twaun Moore,NOP ,29,81,79,100%,115,215,53.5,62.6,58.10%,76,125,60.8,41.90%,39,90,43.3
Pau Gasol,SAS ,37,76,69,100%,97,214,45.3,50.7,75.20%,74,161,46,24.80%,23,53,43.4
DeMarre Carroll,BKN ,31,71,70,100%,100,213,46.9,57,44.60%,57,95,60,55.40%,43,118,36.4
Eric Gordon,HOU ,29,69,64,100%,98,213,46,55.2,43.70%,59,93,63.4,56.30%,39,120,32.5
DeAndre Jordan,LAC ,29,77,68,100%,136,212,64.2,64.2,100%,136,212,64.2,0.00%,0,0,-
Joe Ingles,UTA ,30,82,78,100%,106,211,50.2,65.4,33.60%,42,71,59.2,66.40%,64,140,45.7
DeMarcus Cousins,NOP ,27,48,48,100%,105,211,49.8,57.3,64.90%,73,137,53.3,35.10%,32,74,43.2
Dillon Brooks,MEM ,22,82,75,100%,103,211,48.8,55.5,62.60%,75,132,56.8,37.40%,28,79,35.4
Bogdan Bogdanovic,SAC ,25,78,74,100%,100,210,47.6,55,60.50%,69,127,54.3,39.50%,31,83,37.3
Marcin Gortat,WAS ,34,82,80,100%,110,209,52.6,52.6,100%,110,209,52.6,0.00%,0,0,-
Marvin Williams,CHA ,31,78,74,100%,110,203,54.2,69,44.30%,50,90,55.6,55.70%,60,113,53.1
Jimmy Butler,MIN ,28,59,58,100%,108,203,53.2,57.1,81.30%,92,165,55.8,18.70%,16,38,42.1
Tyler Johnson,MIA ,26,71,68,100%,97,203,47.8,55.4,52.20%,66,106,62.3,47.80%,31,97,32
De'Aaron Fox,SAC ,20,73,73,100%,90,203,44.3,47.8,74.40%,76,151,50.3,25.60%,14,52,26.9
Jae Crowder,UTA ,27,80,76,100%,81,202,40.1,48.5,45.50%,47,92,51.1,54.50%,34,110,30.9
Kyle Kuzma,LAL ,22,76,65,100%,98,201,48.8,56.2,57.20%,68,115,59.1,42.80%,30,86,34.9
Al Horford,BOS ,31,69,68,100%,99,198,50,55.6,76.30%,77,151,51,23.70%,22,47,46.8
Hassan Whiteside,MIA ,28,54,52,100%,110,196,56.1,56.4,99.50%,109,195,55.9,0.50%,1,1,100
Marco Belinelli,PHI ,32,79,75,100%,91,196,46.4,54.6,56.10%,59,110,53.6,43.90%,32,86,37.2
Dirk Nowitzki,DAL ,39,77,74,100%,86,196,43.9,51,58.70%,58,115,50.4,41.30%,28,81,34.6
Jayson Tatum,BOS ,20,77,72,100%,102,195,52.3,59.7,70.80%,73,138,52.9,29.20%,29,57,50.9
Trevor Ariza,HOU ,32,67,62,100%,97,195,49.7,63.6,32.30%,43,63,68.3,67.70%,54,132,40.9
Willie Cauley-Stein,SAC ,24,73,66,100%,108,193,56,56,99.50%,108,192,56.3,0.50%,0,1,0
Elfrid Payton,PHX ,24,63,60,100%,101,188,53.7,55.9,86.20%,93,162,57.4,13.80%,8,26,30.8
Avery Bradley,LAC ,27,46,45,100%,86,188,45.7,51.6,67.60%,64,127,50.4,32.40%,22,61,36.1
JR Smith,CLE ,32,80,72,100%,85,184,46.2,59.8,34.80%,35,64,54.7,65.20%,50,120,41.7
Kris Dunn,CHI ,24,52,51,100%,85,182,46.7,49.7,84.60%,74,154,48.1,15.40%,11,28,39.3
Darren Collison,IND ,30,68,65,100%,93,180,51.7,60.6,65.60%,61,118,51.7,34.40%,32,62,51.6
Clint Capela,HOU ,24,74,66,100%,120,179,67,67,100%,120,179,67,0.00%,0,0,-
Wesley Matthews,DAL ,31,63,59,100%,80,179,44.7,55.3,44.70%,42,80,52.5,55.30%,38,99,38.4
Jonathon Simmons,ORL ,28,69,61,100%,85,177,48,53.4,73.40%,66,130,50.8,26.60%,19,47,40.4
Evan Turner,POR ,29,79,74,100%,84,177,47.5,50.6,78.50%,73,139,52.5,21.50%,11,38,28.9
John Wall,WAS ,27,41,41,100%,83,177,46.9,52.5,70.10%,63,124,50.8,29.90%,20,53,37.7
Wilson Chandler,DEN ,31,74,69,100%,69,177,39,46.6,54.80%,42,97,43.3,45.20%,27,80,33.8
D'Angelo Russell,BKN ,22,48,47,100%,76,176,43.2,53.1,48.90%,41,86,47.7,51.10%,35,90,38.9
Jordan Clarkson,CLE ,25,80,73,100%,71,176,40.3,43.2,71.60%,61,126,48.4,28.40%,10,50,20
Rondae Hollis-Jefferson,BKN ,23,66,62,100%,86,175,49.1,49.7,90.90%,84,159,52.8,9.10%,2,16,12.5
Rodney Hood,CLE ,25,60,59,100%,70,174,40.2,46.8,57.50%,47,100,47,42.50%,23,74,31.1
Michael Kidd-Gilchrist,CHA ,24,74,69,100%,96,172,55.8,55.8,99.40%,96,171,56.1,0.60%,0,1,0
Reggie Bullock,DET ,27,55,51,100%,88,171,51.5,62.3,49.70%,51,85,60,50.30%,37,86,43
Robert Covington,PHI ,27,79,65,100%,81,171,47.4,62.3,30.40%,30,52,57.7,69.60%,51,119,42.9
Ish Smith,DET ,29,82,74,100%,89,170,52.4,54.4,87.60%,82,149,55,12.40%,7,21,33.3
Rajon Rondo,NOP ,32,64,62,100%,85,170,50,56.8,63.50%,62,108,57.4,36.50%,23,62,37.1
Aron Baynes,BOS ,31,78,68,100%,84,164,51.2,52.1,94.50%,81,155,52.3,5.50%,3,9,33.3
Terry Rozier,BOS ,24,76,64,100%,69,164,42.1,51.8,49.40%,37,81,45.7,50.60%,32,83,38.6
Al-Farouq Aminu,POR ,27,69,61,100%,75,162,46.3,58,45.70%,37,74,50,54.30%,38,88,43.2
Chris Paul,HOU ,33,58,56,100%,75,162,46.3,58,48.10%,37,78,47.4,51.90%,38,84,45.2
Domantas Sabonis,IND ,22,74,67,100%,90,160,56.3,56.9,94.40%,88,151,58.3,5.60%,2,9,22.2
Ersan Ilyasova,PHI ,31,68,58,100%,82,160,51.3,60,57.50%,54,92,58.7,42.50%,28,68,41.2
Denzel Valentine,CHI ,24,76,68,100%,74,159,46.5,57.5,50.90%,39,81,48.1,49.10%,35,78,44.9
Spencer Dinwiddie,BKN ,25,78,66,100%,62,157,39.5,49.7,31.80%,30,50,60,68.20%,32,107,29.9
Buddy Hield,SAC ,24,79,65,100%,83,155,53.5,62.9,60.60%,54,94,57.4,39.40%,29,61,47.5
Draymond Green,GSW ,28,70,65,100%,67,155,43.2,49.7,53.50%,47,83,56.6,46.50%,20,72,27.8
George Hill,CLE ,32,67,61,100%,66,155,42.6,48.4,61.90%,48,96,50,38.10%,18,59,30.5
Michael Beasley,NYK ,29,62,52,100%,86,152,56.6,59.5,87.50%,77,133,57.9,12.50%,9,19,47.4
Reggie Jackson,DET ,28,45,44,100%,74,152,48.7,55.3,65.80%,54,100,54,34.20%,20,52,38.5
James Johnson,MIA ,31,72,61,100%,76,151,50.3,56,64.90%,59,98,60.2,35.10%,17,53,32.1
Kent Bazemore,ATL ,28,64,59,100%,64,151,42.4,48.7,68.90%,45,104,43.3,31.10%,19,47,40.4
Tyreke Evans,MEM ,28,52,49,100%,84,150,56,63.3,64.70%,62,97,63.9,35.30%,22,53,41.5
Danny Green,SAS ,30,70,62,100%,61,149,40.9,48.3,48.30%,39,72,54.2,51.70%,22,77,28.6
Patty Mills,SAS ,29,81,68,100%,72,148,48.6,59.8,45.30%,39,67,58.2,54.70%,33,81,40.7
J.J. Barea,DAL ,33,68,64,100%,69,148,46.6,54.7,58.10%,45,86,52.3,41.90%,24,62,38.7
Jeremy Lamb,CHA ,25,80,66,100%,70,147,47.6,55.8,61.90%,46,91,50.5,38.10%,24,56,42.9
John Henson,MIL ,27,72,62,100%,87,145,60,60,100%,87,145,60,0.00%,0,0,-
Kelly Oubre Jr.,WAS ,22,81,71,100%,64,145,44.1,53.8,51.70%,36,75,48,48.30%,28,70,40
Nikola Mirotic,NOP ,27,54,48,100%,72,143,50.3,59.8,51.70%,45,74,60.8,48.30%,27,69,39.1
Yogi Ferrell,DAL ,25,80,67,100%,69,143,48.3,57.3,49.70%,43,71,60.6,50.30%,26,72,36.1
Stanley Johnson,DET ,21,67,59,100%,59,142,41.5,49.3,54.20%,37,77,48.1,45.80%,22,65,33.8
Marcus Morris,BOS ,28,52,50,100%,63,141,44.7,53.5,58.90%,38,83,45.8,41.10%,25,58,43.1
Bobby Portis,CHI ,23,71,59,100%,72,139,51.8,58.6,67.60%,53,94,56.4,32.40%,19,45,42.2
Caris LeVert,BKN ,23,69,60,100%,66,139,47.5,56.1,60.40%,42,84,50,39.60%,24,55,43.6
Skal Labissiere,SAC ,22,57,50,100%,59,139,42.4,45.3,85.60%,51,119,42.9,14.40%,8,20,40
Rudy Gay,SAS ,31,57,54,100%,62,138,44.9,49.6,74.60%,49,103,47.6,25.40%,13,35,37.1
Tyler Ulis,PHX ,22,64,59,100%,54,136,39.7,44.5,67.60%,41,92,44.6,32.40%,13,44,29.5
Troy Daniels,PHX ,26,74,60,100%,53,136,39,54.4,19.90%,11,27,40.7,80.10%,42,109,38.5
Dragan Bender,PHX ,20,80,66,100%,51,134,38.1,50.4,33.60%,18,45,40,66.40%,33,89,37.1
Ryan Anderson,HOU ,30,66,53,100%,63,133,47.4,66.2,18.00%,13,24,54.2,82.00%,50,109,45.9
Dewayne Dedmon,ATL ,28,61,52,100%,70,131,53.4,59.5,69.50%,54,91,59.3,30.50%,16,40,40
Joe Harris,BKN ,26,77,65,100%,68,131,51.9,65.3,37.40%,33,49,67.3,62.60%,35,82,42.7
Tony Snell,MIL ,26,74,64,100%,58,129,45,56.6,36.40%,28,47,59.6,63.60%,30,82,36.6
Marquese Chriss,PHX ,20,72,64,100%,53,129,41.1,46.9,55.00%,38,71,53.5,45.00%,15,58,25.9
Garrett Temple,SAC ,32,65,55,100%,52,128,40.6,48.8,53.90%,31,69,44.9,46.10%,21,59,35.6
Lonzo Ball,LAL ,20,51,47,100%,43,128,33.6,43,42.20%,19,54,35.2,57.80%,24,74,32.4
Paul Millsap,DEN ,33,37,37,100%,67,127,52.8,58.3,77.20%,53,98,54.1,22.80%,14,29,48.3
Frank Kaminsky,CHA ,25,78,68,100%,55,127,43.3,53.1,56.70%,30,72,41.7,43.30%,25,55,45.5
Kelly Olynyk,MIA ,27,74,59,100%,64,126,50.8,61.1,51.60%,38,65,58.5,48.40%,26,61,42.6
CJ Miles,TOR ,31,66,58,100%,53,126,42.1,59.1,19.00%,10,24,41.7,81.00%,43,102,42.2
Dejounte Murray,SAS ,21,67,61,100%,49,126,38.9,39.7,92.10%,47,116,40.5,7.90%,2,10,20
Jarrett Jack,NYK ,34,57,54,100%,60,125,48,52,78.40%,50,98,51,21.60%,10,27,37
Justin Jackson,SAC ,23,59,49,100%,54,124,43.5,49.2,59.70%,40,74,54.1,40.30%,14,50,28
Rudy Gobert,UTA ,25,56,50,100%,87,122,71.3,71.3,100%,87,122,71.3,0.00%,0,0,-
OG Anunoby,TOR ,20,71,60,100%,65,122,53.3,66,41.00%,34,50,68,59.00%,31,72,43.1
Marcus Smart,BOS ,24,51,43,100%,42,122,34.4,41.8,48.40%,24,59,40.7,51.60%,18,63,28.6
JaMychal Green,MEM ,27,55,53,100%,66,119,55.5,58.8,73.10%,58,87,66.7,26.90%,8,32,25
Jamal Crawford,MIN ,38,77,61,100%,54,119,45.4,52.5,52.90%,37,63,58.7,47.10%,17,56,30.4
Wayne Ellington,MIA ,30,71,64,100%,50,116,43.1,61.2,15.50%,8,18,44.4,84.50%,42,98,42.9
Mario Hezonja,ORL ,23,57,47,100%,61,115,53,59.6,60.90%,46,70,65.7,39.10%,15,45,33.3
D.J. Augustin,ORL ,30,72,51,100%,59,115,51.3,61.3,57.40%,36,66,54.5,42.60%,23,49,46.9
Jarell Martin,MEM ,24,68,55,100%,54,115,47,50.4,80.90%,46,93,49.5,19.10%,8,22,36.4
Tony Parker,SAS ,36,55,46,100%,59,114,51.8,52.6,93.00%,57,106,53.8,7.00%,2,8,25
Wesley Johnson,LAC ,30,70,52,100%,51,114,44.7,53.1,54.40%,32,62,51.6,45.60%,19,52,36.5
Zaza Pachulia,GSW ,34,66,55,100%,72,113,63.7,63.7,100%,72,113,63.7,0.00%,0,0,-
Dante Cunningham,BKN ,31,71,57,100%,55,112,49.1,57.1,50.00%,37,56,66.1,50.00%,18,56,32.1
T.J. McConnell,PHI ,26,74,61,100%,64,111,57.7,61.7,82.90%,55,92,59.8,17.10%,9,19,47.4
Lance Stephenson,IND ,27,80,60,100%,49,111,44.1,50.9,59.50%,34,66,51.5,40.50%,15,45,33.3
John Collins,ATL ,20,73,52,100%,77,110,70,71.8,90.00%,73,99,73.7,10.00%,4,11,36.4
Dwyane Wade,MIA ,36,67,57,100%,56,109,51.4,54.6,85.30%,49,93,52.7,14.70%,7,16,43.8
Dion Waiters,MIA ,26,29,29,100%,48,109,44,51.8,58.70%,31,64,48.4,41.30%,17,45,37.8
Emmanuel Mudiay,NYK ,22,57,44,100%,41,108,38,44,60.20%,28,65,43.1,39.80%,13,43,30.2
Cory Joseph,IND ,26,81,62,100%,44,107,41.1,45.3,71.00%,35,76,46.1,29.00%,9,31,29
Manu Ginobili,SAS ,40,64,55,100%,49,105,46.7,51.4,65.70%,39,69,56.5,34.30%,10,36,27.8
Jeff Green,CLE ,31,77,53,100%,53,104,51,55.3,71.20%,44,74,59.5,28.80%,9,30,30
Trey Lyles,DEN ,22,54,49,100%,45,104,43.3,51.9,50.00%,27,52,51.9,50.00%,18,52,34.6
Larry Nance Jr.,CLE ,25,62,48,100%,56,103,54.4,54.4,97.10%,56,100,56,2.90%,0,3,0
JaVale McGee,GSW ,30,56,43,100%,63,102,61.8,61.8,100%,63,102,61.8,0.00%,0,0,-
Mason Plumlee,DEN ,28,71,47,100%,57,101,56.4,56.4,99.00%,57,100,57,1.00%,0,1,0
Kyle Anderson,SAS ,24,74,56,100%,52,101,51.5,55,84.20%,45,85,52.9,15.80%,7,16,43.8
Mario Chalmers,MEM ,32,63,56,100%,40,101,39.6,46.5,51.50%,26,52,50,48.50%,14,49,28.6
Pat Connaughton,POR ,25,80,58,100%,46,99,46.5,57.6,44.40%,24,44,54.5,55.60%,22,55,40
Malcolm Brogdon,MIL ,25,46,41,100%,51,98,52,59.7,60.20%,36,59,61,39.80%,15,39,38.5
Maxi Kleber,DAL ,26,56,48,100%,49,98,50,57.7,61.20%,34,60,56.7,38.80%,15,38,39.5
Justise Winslow,MIA ,22,66,52,100%,44,98,44.9,51,69.40%,32,68,47.1,30.60%,12,30,40
Gorgui Dieng,MIN ,28,79,57,100%,47,97,48.5,50.5,82.50%,43,80,53.8,17.50%,4,17,23.5
Milos Teodosic,LAC ,31,45,41,100%,44,97,45.4,57.7,41.20%,20,40,50,58.80%,24,57,42.1
Luc Mbah a Moute,HOU ,31,61,50,100%,53,96,55.2,67.7,41.70%,29,40,72.5,58.30%,24,56,42.9
Isaiah Thomas,LAL ,29,31,31,100%,34,96,35.4,42.2,49.00%,21,47,44.7,51.00%,13,49,26.5
Jerian Grant,CHI ,25,72,52,100%,36,95,37.9,43.2,62.10%,26,59,44.1,37.90%,10,36,27.8
Nick Young,GSW ,32,60,47,100%,41,94,43.6,59,28.70%,12,27,44.4,71.30%,29,67,43.3
PJ Tucker,HOU ,33,82,52,100%,40,94,42.6,58.5,23.40%,10,22,45.5,76.60%,30,72,41.7
Bismack Biyombo,ORL ,25,77,46,100%,57,93,61.3,61.3,100%,57,93,61.3,0.00%,0,0,-
Nene,HOU ,35,51,46,100%,57,92,62,62,100%,57,92,62,0.00%,0,0,-
Alec Burks,UTA ,26,52,46,100%,35,92,38,44.6,56.50%,23,52,44.2,43.50%,12,40,30
Ben McLemore,MEM ,25,51,42,100%,52,91,57.1,68.1,61.50%,32,56,57.1,38.50%,20,35,57.1
Jabari Parker,MIL ,23,31,30,100%,49,91,53.8,58.8,76.90%,40,70,57.1,23.10%,9,21,42.9
Dwight Powell,DAL ,26,71,46,100%,51,90,56.7,60.6,75.60%,44,68,64.7,24.40%,7,22,31.8
Doug McDermott,DAL ,26,70,50,100%,46,90,51.1,61.1,52.20%,28,47,59.6,47.80%,18,43,41.9
Devin Harris,DEN ,35,69,48,100%,34,90,37.8,44.4,48.90%,22,44,50,51.10%,12,46,26.1
David Nwaba,CHI ,25,57,42,100%,43,88,48.9,51.7,87.50%,38,77,49.4,12.50%,5,11,45.5
Frank Ntilikina,NYK ,19,75,52,100%,33,88,37.5,42.6,62.50%,24,55,43.6,37.50%,9,33,27.3
Alex Len,PHX ,24,69,50,100%,50,87,57.5,57.5,100%,50,87,57.5,0.00%,0,0,-
Trevor Booker,IND ,30,65,47,100%,49,87,56.3,57.5,88.50%,47,77,61,11.50%,2,10,20
Gerald Green,HOU ,32,36,34,100%,37,87,42.5,56.3,28.70%,13,25,52,71.30%,24,62,38.7
Tomas Satoransky,WAS ,26,64,42,100%,53,86,61.6,68,76.70%,42,66,63.6,23.30%,11,20,55
Bam Adebayo,MIA ,20,57,40,100%,44,86,51.2,51.2,97.70%,44,84,52.4,2.30%,0,2,0
Andrew Harrison,MEM ,23,51,47,100%,40,86,46.5,54.1,62.80%,27,54,50,37.20%,13,32,40.6
Tyler Zeller,MIL ,28,55,41,100%,52,85,61.2,63.5,87.10%,48,74,64.9,12.90%,4,11,36.4
Greg Monroe,BOS ,27,47,39,100%,51,85,60,60,100%,51,85,60,0.00%,0,0,-
Kosta Koufos,SAC ,29,70,44,100%,50,84,59.5,59.5,100%,50,84,59.5,0.00%,0,0,-
Kyle O'Quinn,NYK ,28,68,46,100%,46,84,54.8,54.8,97.60%,46,82,56.1,2.40%,0,2,0
Jonas Jerebko,UTA ,31,69,49,100%,40,84,47.6,56.5,56.00%,25,47,53.2,44.00%,15,37,40.5
Quincy Acy,BKN ,27,59,48,100%,29,84,34.5,49.4,10.70%,4,9,44.4,89.30%,25,75,33.3
Jarrett Allen,BKN ,20,63,47,100%,56,83,67.5,68.1,96.40%,55,80,68.8,3.60%,1,3,33.3
Isaiah Taylor,ATL ,23,55,46,100%,42,83,50.6,55.4,67.50%,34,56,60.7,32.50%,8,27,29.6
Zach LaVine,CHI ,23,24,24,100%,27,81,33.3,37,61.70%,21,50,42,38.30%,6,31,19.4
Mike Scott,WAS ,29,66,45,100%,43,80,53.8,64.4,61.30%,26,49,53.1,38.80%,17,31,54.8
Andre Iguodala,GSW ,34,64,45,100%,42,79,53.2,59.5,64.60%,32,51,62.7,35.40%,10,28,35.7
Chandler Parsons,MEM ,29,36,35,100%,41,79,51.9,62,53.20%,25,42,59.5,46.80%,16,37,43.2
Davis Bertans,SAS ,25,40,33,100%,38,78,48.7,61.5,33.30%,18,26,69.2,66.70%,20,52,38.5
Raymond Felton,OKC ,33,72,48,100%,28,78,35.9,44.2,51.30%,15,40,37.5,48.70%,13,38,34.2
Jakob Poeltl,TOR ,22,74,49,100%,55,77,71.4,71.4,100%,55,77,71.4,0.00%,0,0,-
Anthony Tolliver,DET ,32,55,43,100%,44,77,57.1,80.5,16.90%,8,13,61.5,83.10%,36,64,56.3
Maurice Harkless,POR ,25,52,42,100%,41,76,53.9,65.1,47.40%,24,36,66.7,52.60%,17,40,42.5
Ian Clark,NOP ,27,56,39,100%,37,76,48.7,56.6,57.90%,25,44,56.8,42.10%,12,32,37.5
Montrezl Harrell,LAC ,24,65,39,100%,47,75,62.7,63.3,94.70%,46,71,64.8,5.30%,1,4,25
Amir Johnson,PHI ,31,73,46,100%,46,74,62.2,64.9,83.80%,42,62,67.7,16.20%,4,12,33.3
James Ennis III,DET ,27,66,41,100%,38,74,51.4,58.1,62.20%,28,46,60.9,37.80%,10,28,35.7
Thon Maker,MIL ,21,68,42,100%,38,74,51.4,54.7,73.00%,33,54,61.1,27.00%,5,20,25
Corey Brewer,OKC ,32,58,38,100%,32,73,43.8,49.3,60.30%,24,44,54.5,39.70%,8,29,27.6
Joe Johnson,HOU ,36,52,42,100%,28,73,38.4,43.2,61.60%,21,45,46.7,38.40%,7,28,25
Tyrone Wallace,LAC ,23,30,26,100%,44,72,61.1,61.8,88.90%,43,64,67.2,11.10%,1,8,12.5
Jerami Grant,OKC ,24,79,51,100%,40,72,55.6,59.7,66.70%,34,48,70.8,33.30%,6,24,25
Darius Miller,NOP ,28,76,52,100%,34,72,47.2,61.8,31.90%,13,23,56.5,68.10%,21,49,42.9
Pascal Siakam,TOR ,24,77,43,100%,32,72,44.4,47.2,69.40%,28,50,56,30.60%,4,22,18.2
Danilo Gallinari,LAC ,29,21,21,100%,30,72,41.7,47.9,61.10%,21,44,47.7,38.90%,9,28,32.1
Tyler Dorsey,ATL ,22,30,27,100%,27,72,37.5,46.5,38.90%,14,28,50,61.10%,13,44,29.5
Tristan Thompson,CLE ,27,47,31,100%,44,69,63.8,63.8,100%,44,69,63.8,0.00%,0,0,-
C.J. Williams,LAC ,28,29,26,100%,36,67,53.7,60.4,56.70%,27,38,71.1,43.30%,9,29,31
Lance Thomas,NYK ,30,62,40,100%,30,67,44.8,53.7,53.70%,18,36,50,46.30%,12,31,38.7
Luke Kennard,DET ,21,58,34,100%,28,66,42.4,52.3,59.10%,15,39,38.5,40.90%,13,27,48.1
Ian Mahinmi,WAS ,31,70,44,100%,35,65,53.8,53.8,96.90%,35,63,55.6,3.10%,0,2,0
Wayne Selden,MEM ,23,33,30,100%,27,65,41.5,47.7,56.90%,19,37,51.4,43.10%,8,28,28.6
Alex Abrines,OKC ,24,45,32,100%,26,65,40,56.2,24.60%,5,16,31.3,75.40%,21,49,42.9
Mike James,NOP ,27,28,26,100%,22,65,33.8,38.5,63.10%,16,41,39,36.90%,6,24,25
Quinn Cook,GSW ,25,26,22,100%,34,63,54,64.3,52.40%,21,33,63.6,47.60%,13,30,43.3
Timothe Luwawu-Cabarrot,PHI ,23,40,32,100%,31,63,49.2,61.9,39.70%,15,25,60,60.30%,16,38,42.1
Jerryd Bayless,PHI ,29,37,30,100%,29,63,46,57.1,46.00%,15,29,51.7,54.00%,14,34,41.2
Tyus Jones,MIN ,22,75,39,100%,25,63,39.7,41.3,65.10%,23,41,56.1,34.90%,2,22,9.1
Nemanja Bjelica,MIN ,30,60,33,100%,31,62,50,64.5,43.50%,13,27,48.1,56.50%,18,35,51.4
Tyson Chandler,PHX ,35,46,34,100%,39,60,65,65,100%,39,60,65,0.00%,0,0,-
Deyonta Davis,MEM ,21,54,33,100%,38,60,63.3,63.3,100%,38,60,63.3,0.00%,0,0,-
Ed Davis,POR ,28,78,38,100%,35,60,58.3,58.3,100%,35,60,58.3,0.00%,0,0,-
Trey Burke,NYK ,25,23,18,100%,31,60,51.7,56.7,73.30%,25,44,56.8,26.70%,6,16,37.5
Bryn Forbes,SAS ,24,51,32,100%,28,60,46.7,56.7,45.00%,16,27,59.3,55.00%,12,33,36.4
Zach Collins,POR ,20,57,37,100%,23,60,38.3,43.3,53.30%,17,32,53.1,46.70%,6,28,21.4
Mike Muscala,ATL ,26,40,31,100%,20,60,33.3,40,51.70%,12,31,38.7,48.30%,8,29,27.6
Josh Hart,LAL ,23,46,29,100%,27,59,45.8,57.6,40.70%,13,24,54.2,59.30%,14,35,40
Shabazz Napier,POR ,26,42,27,100%,21,59,35.6,42.4,66.10%,13,39,33.3,33.90%,8,20,40
Jose Calderon,CLE ,36,39,30,100%,31,58,53.4,65.5,50.00%,17,29,58.6,50.00%,14,29,48.3
Miles Plumlee,ATL ,29,53,36,100%,36,57,63.2,63.2,100%,36,57,63.2,0.00%,0,0,-
Frank Mason,SAC ,24,46,33,100%,21,54,38.9,41.7,79.60%,18,43,41.9,20.40%,3,11,27.3
Malcolm Delaney,ATL ,29,44,32,100%,17,52,32.7,41.3,50.00%,8,26,30.8,50.00%,9,26,34.6
Malik Monk,CHA ,20,38,28,100%,16,51,31.4,37.3,45.10%,10,23,43.5,54.90%,6,28,21.4
Kyle Korver,CLE ,37,65,30,100%,26,50,52,69,36.00%,9,18,50,64.00%,17,32,53.1
Thabo Sefolosha,UTA ,34,34,27,100%,20,50,40,43,66.00%,17,33,51.5,34.00%,3,17,17.6
Marreese Speights,ORL ,30,34,24,100%,21,49,42.9,57.1,22.40%,7,11,63.6,77.60%,14,38,36.8
Richaun Holmes,PHI ,24,30,24,100%,31,48,64.6,64.6,87.50%,31,42,73.8,12.50%,0,6,0
Jordan Bell,GSW ,23,39,25,100%,29,48,60.4,60.4,100%,29,48,60.4,0.00%,0,0,-
Cameron Payne,CHI ,23,25,21,100%,26,48,54.2,62.5,62.50%,18,30,60,37.50%,8,18,44.4
Luke Babbitt,MIA ,28,31,22,100%,26,48,54.2,71.9,29.20%,9,14,64.3,70.80%,17,34,50
Norman Powell,TOR ,25,43,29,100%,23,48,47.9,58.3,45.80%,13,22,59.1,54.20%,10,26,38.5
Noah Vonleh,CHI ,22,34,24,100%,21,48,43.8,47.9,75.00%,17,36,47.2,25.00%,4,12,33.3
Langston Galloway,DET ,26,36,25,100%,18,48,37.5,45.8,41.70%,10,20,50,58.30%,8,28,28.6
Sindarius Thornwell,LAC ,23,58,30,100%,24,46,52.2,58.7,73.90%,18,34,52.9,26.10%,6,12,50
Jawun Evans,LAC ,21,41,24,100%,21,46,45.7,53.3,71.70%,14,33,42.4,28.30%,7,13,53.8
Delon Wright,TOR ,26,53,27,100%,20,46,43.5,47.8,56.50%,16,26,61.5,43.50%,4,20,20
Andre Roberson,OKC ,26,37,27,100%,27,45,60,61.1,77.80%,26,35,74.3,22.20%,1,10,10
Terrence Ross,ORL ,27,24,21,100%,21,44,47.7,54.5,47.70%,15,21,71.4,52.30%,6,23,26.1
Fred VanVleet,TOR ,24,65,31,100%,21,44,47.7,60.2,43.20%,10,19,52.6,56.80%,11,25,44
Sterling Brown,MIL ,23,37,28,100%,20,44,45.5,54.5,54.50%,12,24,50,45.50%,8,20,40
Salah Mejri,DAL ,31,48,28,100%,27,43,62.8,62.8,100%,27,43,62.8,0.00%,0,0,-
Justin Anderson,PHI ,24,27,21,100%,25,43,58.1,70.9,48.80%,14,21,66.7,51.20%,11,22,50
Kobi Simmons,MEM ,20,26,21,100%,21,43,48.8,51.2,76.70%,19,33,57.6,23.30%,2,10,20
Shaun Livingston,GSW ,32,38,25,100%,21,42,50,50,95.20%,21,40,52.5,4.80%,0,2,0
Wes Iwundu,ORL ,23,45,23,100%,16,42,38.1,39.3,66.70%,15,28,53.6,33.30%,1,14,7.1
Patrick Beverley,LAC ,29,11,11,100%,14,42,33.3,44,45.20%,5,19,26.3,54.80%,9,23,39.1
Joffrey Lauvergne,SAS ,26,28,21,100%,16,41,39,39,97.60%,16,40,40,2.40%,0,1,0
Al Jefferson,IND ,33,27,19,100%,22,40,55,55,97.50%,22,39,56.4,2.50%,0,1,0
Cedi Osman,CLE ,23,29,19,100%,18,40,45,51.3,60.00%,13,24,54.2,40.00%,5,16,31.3
Royce O'Neale,UTA ,24,48,26,100%,22,39,56.4,65.4,61.50%,15,24,62.5,38.50%,7,15,46.7
Omri Casspi,GSW ,29,30,20,100%,21,39,53.8,56.4,89.70%,19,35,54.3,10.30%,2,4,50
Shelvin Mack,ORL ,28,52,28,100%,21,39,53.8,66.7,53.80%,11,21,52.4,46.20%,10,18,55.6
Jameer Nelson,DET ,36,47,24,100%,16,39,41,55.1,33.30%,5,13,38.5,66.70%,11,26,42.3
Mike Conley,MEM ,30,12,11,100%,14,38,36.8,46.1,50.00%,7,19,36.8,50.00%,7,19,36.8
Michael Carter-Williams,CHA ,26,50,26,100%,9,38,23.7,23.7,81.60%,9,31,29,18.40%,0,7,0
Sam Dekker,LAC ,24,52,25,100%,14,37,37.8,39.2,67.60%,13,25,52,32.40%,1,12,8.3
Matthew Dellavedova,MIL ,27,37,23,100%,11,37,29.7,33.8,54.10%,8,20,40,45.90%,3,17,17.6
Vince Carter,SAC ,41,43,30,100%,11,37,29.7,39.2,29.70%,4,11,36.4,70.30%,7,26,26.9
Torrey Craig,DEN ,27,37,24,100%,19,36,52.8,58.3,55.60%,15,20,75,44.40%,4,16,25
Patrick McCaw,GSW ,22,41,24,100%,16,36,44.4,47.2,77.80%,14,28,50,22.20%,2,8,25
Nerlens Noel,DAL ,24,25,19,100%,22,35,62.9,62.9,97.10%,22,34,64.7,2.90%,0,1,0
Tyler Ennis,LAL ,23,34,20,100%,19,35,54.3,57.1,71.40%,17,25,68,28.60%,2,10,20
Jodie Meeks,WAS ,30,54,26,100%,13,35,37.1,48.6,51.40%,5,18,27.8,48.60%,8,17,47.1
Cristiano Felicio,CHI ,25,33,19,100%,26,34,76.5,76.5,100%,26,34,76.5,0.00%,0,0,-
Kevon Looney,GSW ,22,43,20,100%,22,34,64.7,64.7,97.10%,22,33,66.7,2.90%,0,1,0
Dwayne Bacon,CHA ,22,31,20,100%,16,33,48.5,54.5,69.70%,12,23,52.2,30.30%,4,10,40
Sean Kilpatrick,CHI ,28,23,17,100%,14,33,42.4,51.5,42.40%,8,14,57.1,57.60%,6,19,31.6
Damion Lee,ATL ,25,13,12,100%,13,33,39.4,42.4,60.60%,11,20,55,39.40%,2,13,15.4
Derrick Rose,MIN ,29,15,11,100%,19,32,59.4,62.5,81.30%,17,26,65.4,18.80%,2,6,33.3
Daniel Theis,BOS ,26,50,21,100%,18,32,56.3,60.9,78.10%,15,25,60,21.90%,3,7,42.9
Tim Frazier,WAS ,27,42,19,100%,13,32,40.6,50,62.50%,7,20,35,37.50%,6,12,50
Emeka Okafor,NOP ,35,22,17,100%,19,31,61.3,61.3,100%,19,31,61.3,0.00%,0,0,-
Jonathan Isaac,ORL ,20,27,16,100%,15,31,48.4,56.5,67.70%,10,21,47.6,32.30%,5,10,50
Paul Zipser,CHI ,24,34,19,100%,13,31,41.9,50,67.70%,8,21,38.1,32.30%,5,10,50
Josh Huestis,OKC ,26,46,18,100%,10,31,32.3,38.7,41.90%,6,13,46.2,58.10%,4,18,22.2
Tarik Black,HOU ,26,25,17,100%,25,30,83.3,83.3,96.70%,25,29,86.2,3.30%,0,1,0
Patrick Patterson,OKC ,29,68,23,100%,13,30,43.3,56.7,26.70%,5,8,62.5,73.30%,8,22,36.4
Tyler Cavanaugh,ATL ,24,30,19,100%,11,30,36.7,45,36.70%,6,11,54.5,63.30%,5,19,26.3
Johnny O'Bryant III,CHA ,24,27,15,100%,11,30,36.7,40,73.30%,9,22,40.9,26.70%,2,8,25
Brandon Paul,SAS ,27,24,15,100%,9,30,30,35,50.00%,6,15,40,50.00%,3,15,20
Dorian Finney-Smith,DAL ,25,21,15,100%,12,28,42.9,51.8,39.30%,7,11,63.6,60.70%,5,17,29.4
Nik Stauskas,BKN ,24,27,18,100%,10,28,35.7,44.6,32.10%,5,9,55.6,67.90%,5,19,26.3
Danuel House,PHX ,24,15,12,100%,10,28,35.7,41.1,42.90%,7,12,58.3,57.10%,3,16,18.8
Kawhi Leonard,SAS ,26,9,9,100%,12,27,44.4,46.3,66.70%,11,18,61.1,33.30%,1,9,11.1
Treveon Graham,CHA ,24,45,17,100%,12,27,44.4,50,70.40%,9,19,47.4,29.60%,3,8,37.5
Kenneth Faried,DEN ,28,16,13,100%,8,27,29.6,29.6,100%,8,27,29.6,0.00%,0,0,-
Ivan Rabb,MEM ,21,25,16,100%,17,26,65.4,65.4,100%,17,26,65.4,0.00%,0,0,-
Brandan Wright,HOU ,30,23,15,100%,14,26,53.8,53.8,100%,14,26,53.8,0.00%,0,0,-
Dwight Buycks,DET ,29,22,15,100%,10,26,38.5,44.2,61.50%,7,16,43.8,38.50%,3,10,30
Terrance Ferguson,OKC ,20,35,21,100%,8,26,30.8,40.4,26.90%,3,7,42.9,73.10%,5,19,26.3
Jason Terry,MIL ,40,35,21,100%,12,25,48,64,20.00%,4,5,80,80.00%,8,20,40
Willie Reed,DET ,28,26,17,100%,16,24,66.7,66.7,95.80%,16,23,69.6,4.20%,0,1,0
Channing Frye,LAL ,35,31,18,100%,11,24,45.8,54.2,41.70%,7,10,70,58.30%,4,14,28.6
Semi Ojeleye,BOS ,23,54,20,100%,8,24,33.3,47.9,16.70%,1,4,25,83.30%,7,20,35
Joe Young,IND ,25,31,15,100%,15,23,65.2,80.4,52.20%,8,12,66.7,47.80%,7,11,63.6
Eric Moreland,DET ,26,35,16,100%,15,23,65.2,65.2,100%,15,23,65.2,0.00%,0,0,-
Cheick Diallo,NOP ,21,30,16,100%,15,23,65.2,65.2,100%,15,23,65.2,0.00%,0,0,-
DeAndre' Bembry,ATL ,23,23,14,100%,13,23,56.5,63,78.30%,10,18,55.6,21.70%,3,5,60
Abdel Nader,BOS ,24,18,13,100%,7,23,30.4,37,65.20%,4,15,26.7,34.80%,3,8,37.5
Isaiah Canaan,PHX ,27,19,13,100%,9,22,40.9,47.7,50.00%,6,11,54.5,50.00%,3,11,27.3
Raul Neto,UTA ,26,33,15,100%,11,21,52.4,59.5,66.70%,8,14,57.1,33.30%,3,7,42.9
Ekpe Udoh,UTA ,31,45,13,100%,8,21,38.1,38.1,95.20%,8,20,40,4.80%,0,1,0
Luke Kornet,NYK ,22,12,10,100%,7,21,33.3,42.9,42.90%,3,9,33.3,57.10%,4,12,33.3
Arron Afflalo,ORL ,32,30,15,100%,4,21,19,21.4,57.10%,3,12,25,42.90%,1,9,11.1
JaKarr Sampson,SAC ,25,13,11,100%,14,20,70,72.5,95.00%,13,19,68.4,5.00%,1,1,100
Markelle Fultz,PHI ,20,14,12,100%,14,20,70,70,100%,14,20,70,0.00%,0,0,-
Ivica Zubac,LAL ,21,21,13,100%,12,20,60,60,100%,12,20,60,0.00%,0,0,-
Jamil Wilson,LAC ,27,12,9,100%,10,20,50,62.5,25.00%,5,5,100,75.00%,5,15,33.3
Henry Ellenson,DET ,21,13,11,100%,3,20,15,17.5,65.00%,2,13,15.4,35.00%,1,7,14.3
Malik Beasley,DEN ,21,34,12,100%,10,19,52.6,63.2,47.40%,6,9,66.7,52.60%,4,10,40
Shane Larkin,BOS ,25,26,12,100%,10,19,52.6,57.9,84.20%,8,16,50,15.80%,2,3,66.7
Gary Payton II,LAL ,25,11,10,100%,7,19,36.8,42.1,52.60%,5,10,50,47.40%,2,9,22.2
Ramon Sessions,WAS ,32,15,9,100%,7,19,36.8,39.5,68.40%,6,13,46.2,31.60%,1,6,16.7
DeAndre Liggins,NOP ,30,37,14,100%,7,19,36.8,42.1,57.90%,5,11,45.5,42.10%,2,8,25
Derrick Jones Jr.,MIA ,21,9,7,100%,6,19,31.6,34.2,52.60%,5,10,50,47.40%,1,9,11.1
Willy Hernangomez,CHA ,24,18,10,100%,12,18,66.7,66.7,100%,12,18,66.7,0.00%,0,0,-
Johnathan Motley,DAL ,23,5,5,100%,10,18,55.6,55.6,88.90%,10,16,62.5,11.10%,0,2,0
Glenn Robinson III,IND ,24,22,14,100%,10,18,55.6,58.3,77.80%,9,14,64.3,22.20%,1,4,25
Dante Exum,UTA ,22,14,9,100%,8,18,44.4,50,72.20%,6,13,46.2,27.80%,2,5,40
Cody Zeller,CHA ,25,32,16,100%,8,18,44.4,44.4,100%,8,18,44.4,0.00%,0,0,-
MarShon Brooks,MEM ,29,7,7,100%,7,18,38.9,41.7,83.30%,6,15,40,16.70%,1,3,33.3
Jahlil Okafor,BKN ,22,12,10,100%,8,17,47.1,47.1,100%,8,17,47.1,0.00%,0,0,-
Antonio Blakeney,CHI ,21,15,11,100%,7,17,41.2,41.2,82.40%,7,14,50,17.60%,0,3,0
Meyers Leonard,POR ,26,12,9,100%,12,16,75,78.1,75.00%,11,12,91.7,25.00%,1,4,25
Jared Dudley,PHX ,32,22,10,100%,9,16,56.3,75,43.80%,3,7,42.9,56.30%,6,9,66.7
Shaquille Harrison,PHX ,24,18,8,100%,8,16,50,53.1,62.50%,7,10,70,37.50%,1,6,16.7
Myke Henry,MEM ,25,14,8,100%,7,16,43.8,50,56.30%,5,9,55.6,43.80%,2,7,28.6
Rodney McGruder,MIA ,26,12,7,100%,6,16,37.5,46.9,50.00%,3,8,37.5,50.00%,3,8,37.5
TJ Leaf,IND ,21,39,12,100%,6,16,37.5,40.6,62.50%,5,10,50,37.50%,1,6,16.7
Iman Shumpert,SAC ,27,13,11,100%,5,16,31.3,37.5,50.00%,3,8,37.5,50.00%,2,8,25
Alex Caruso,LAL ,24,28,12,100%,4,15,26.7,30,60.00%,3,9,33.3,40.00%,1,6,16.7
Timofey Mozgov,BKN ,31,16,8,100%,7,14,50,50,85.70%,7,12,58.3,14.30%,0,2,0
Mirza Teletovic,MIL ,32,7,6,100%,7,14,50,75,7.10%,0,1,0,92.90%,7,13,53.8
Tony Allen,NOP ,36,17,9,100%,6,14,42.9,46.4,85.70%,5,12,41.7,14.30%,1,2,50
Jordan Mickey,MIA ,23,11,8,100%,6,14,42.9,42.9,85.70%,6,12,50,14.30%,0,2,0
Kyle Collinsworth,DAL ,26,15,6,100%,5,14,35.7,35.7,92.90%,5,13,38.5,7.10%,0,1,0
Malachi Richardson,TOR ,22,13,9,100%,5,14,35.7,39.3,64.30%,4,9,44.4,35.70%,1,5,20
Lucas Nogueira,TOR ,25,17,8,100%,10,13,76.9,76.9,84.60%,10,11,90.9,15.40%,0,2,0
Andrew White III,ATL ,24,10,8,100%,5,13,38.5,50,38.50%,2,5,40,61.50%,3,8,37.5
Shabazz Muhammad,MIL ,25,7,5,100%,5,13,38.5,42.3,84.60%,4,11,36.4,15.40%,1,2,50
Solomon Hill,NOP ,27,12,10,100%,3,13,23.1,26.9,30.80%,2,4,50,69.20%,1,9,11.1
Damyean Dotson,NYK ,24,16,9,100%,3,13,23.1,23.1,53.80%,3,7,42.9,46.20%,0,6,0
Ante Zizic,CLE ,21,10,8,100%,10,12,83.3,83.3,100%,10,12,83.3,0.00%,0,0,-
Dakari Johnson,OKC ,22,9,8,100%,8,12,66.7,66.7,100%,8,12,66.7,0.00%,0,0,-
Isaiah Whitehead,BKN ,23,7,7,100%,7,12,58.3,62.5,75.00%,6,9,66.7,25.00%,1,3,33.3
Isaiah Hicks,NYK ,23,12,5,100%,7,12,58.3,58.3,91.70%,7,11,63.6,8.30%,0,1,0
Darrell Arthur,DEN ,30,12,7,100%,6,12,50,54.2,58.30%,5,7,71.4,41.70%,1,5,20
Juancho Hernangomez,DEN ,22,8,7,100%,5,12,41.7,54.2,16.70%,2,2,100,83.30%,3,10,30
Rodney Purvis,ORL ,24,10,6,100%,5,12,41.7,54.2,50.00%,2,6,33.3,50.00%,3,6,50
Caleb Swanigan,POR ,21,11,6,100%,6,11,54.5,54.5,100%,6,11,54.5,0.00%,0,0,-
Rashad Vaughn,ORL ,21,9,5,100%,5,11,45.5,63.6,18.20%,1,2,50,81.80%,4,9,44.4
Jon Leuer,DET ,29,8,7,100%,7,10,70,70,90.00%,7,9,77.8,10.00%,0,1,0
Jalen Jones,DAL ,25,6,3,100%,6,10,60,75,50.00%,3,5,60,50.00%,3,5,60
Aaron Harrison,DAL ,23,8,6,100%,1,10,10,15,50.00%,0,5,0,50.00%,1,5,20
Boban Marjanovic,LAC ,29,13,4,100%,5,9,55.6,55.6,100%,5,9,55.6,0.00%,0,0,-
Nigel Hayes,SAC ,23,5,4,100%,5,9,55.6,61.1,55.60%,4,5,80,44.40%,1,4,25
Josh Magette,ATL ,28,9,6,100%,3,9,33.3,38.9,44.40%,2,4,50,55.60%,1,5,20
Jamel Artis,ORL ,25,9,7,100%,3,9,33.3,44.4,33.30%,1,3,33.3,66.70%,2,6,33.3
Davon Reed,PHX ,22,7,5,100%,3,9,33.3,44.4,55.60%,1,5,20,44.40%,2,4,50
Brandon Jennings,MIL ,28,11,4,100%,1,9,11.1,16.7,55.60%,0,5,0,44.40%,1,4,25
Guerschon Yabusele,BOS ,22,12,6,100%,6,8,75,93.8,62.50%,3,5,60,37.50%,3,3,100
Josh Gray,PHX ,24,4,2,100%,4,8,50,62.5,50.00%,2,4,50,50.00%,2,4,50
Okaro White,CLE ,25,5,4,100%,3,8,37.5,50,25.00%,1,2,50,75.00%,2,6,33.3
Xavier Rathan-Mayes,MEM ,24,5,4,100%,2,8,25,25,37.50%,2,3,66.7,62.50%,0,5,0
Quincy Pondexter,CHI ,30,7,6,100%,1,8,12.5,12.5,37.50%,1,3,33.3,62.50%,0,5,0
Khem Birch,ORL ,25,18,5,100%,1,8,12.5,12.5,100%,1,8,12.5,0.00%,0,0,-
Troy Williams,NYK ,23,8,4,100%,4,7,57.1,64.3,71.40%,3,5,60,28.60%,1,2,50
Briante Weber,MEM ,25,10,6,100%,4,6,66.7,66.7,83.30%,4,5,80,16.70%,0,1,0
Ron Baker,NYK ,25,15,5,100%,3,6,50,58.3,50.00%,2,3,66.7,50.00%,1,3,33.3
Alec Peters,PHX ,23,6,3,100%,3,6,50,66.7,16.70%,1,1,100,83.30%,2,5,40
Kay Felder,DET ,23,6,3,100%,2,6,33.3,33.3,66.70%,2,4,50,33.30%,0,2,0
Malcolm Miller,TOR ,25,5,4,100%,2,6,33.3,41.7,16.70%,1,1,100,83.30%,1,5,20
RJ Hunter,HOU ,24,1,1,100%,2,6,33.3,41.7,16.70%,1,1,100,83.30%,1,5,20
Jack Cooley,SAC ,27,6,4,100%,1,6,16.7,16.7,100%,1,6,16.7,0.00%,0,0,-
Omer Asik,CHI ,31,12,5,100%,1,6,16.7,16.7,100%,1,6,16.7,0.00%,0,0,-
Marquis Teague,MEM ,25,3,3,100%,0,6,0,0,83.30%,0,5,0,16.70%,0,1,0
Andrew Bogut,LAL ,33,13,3,100%,4,5,80,80,100%,4,5,80,0.00%,0,0,-
Jaylen Morris,ATL ,22,6,4,100%,2,5,40,40,100%,2,5,40,0.00%,0,0,-
Ryan Arcidiacono,CHI ,24,13,5,100%,2,5,40,50,20.00%,1,1,100,80.00%,1,4,25
Travis Wear,LAL ,27,10,4,100%,2,5,40,60,20.00%,0,1,0,80.00%,2,4,50
Georgios Papagiannis,POR ,20,5,2,100%,2,5,40,40,100%,2,5,40,0.00%,0,0,-
Andre Ingram,LAL ,32,2,1,100%,2,5,40,50,40.00%,1,2,50,60.00%,1,3,33.3
Jason Smith,WAS ,32,7,3,100%,2,5,40,40,40.00%,2,2,100,60.00%,0,3,0
Omari Johnson,MEM ,29,3,2,100%,3,4,75,75,75.00%,3,3,100,25.00%,0,1,0
Antonius Cleveland,ATL ,24,12,3,100%,3,4,75,100,50.00%,1,2,50,50.00%,2,2,100
Derrick White,SAS ,23,3,1,100%,2,4,50,50,75.00%,2,3,66.7,25.00%,0,1,0
Aaron Brooks,MIN ,33,6,3,100%,2,4,50,62.5,75.00%,1,3,33.3,25.00%,1,1,100
John Holland,CLE ,29,4,2,100%,1,4,25,25,50.00%,1,2,50,50.00%,0,2,0
Kadeem Allen,BOS ,25,6,3,100%,1,4,25,25,50.00%,1,2,50,50.00%,0,2,0
James Young,PHI ,22,5,3,100%,1,4,25,37.5,25.00%,0,1,0,75.00%,1,3,33.3
David West,GSW ,37,3,2,100%,2,3,66.7,66.7,100%,2,3,66.7,0.00%,0,0,-
Damien Wilkins,IND ,38,7,3,100%,2,3,66.7,66.7,100%,2,3,66.7,0.00%,0,0,-
Richard Jefferson,DEN ,37,7,3,100%,2,3,66.7,66.7,100%,2,3,66.7,0.00%,0,0,-
Jabari Bird,BOS ,23,3,1,100%,1,3,33.3,50,33.30%,0,1,0,66.70%,1,2,50
Jeremy Lin,BKN ,29,1,1,100%,1,3,33.3,33.3,100%,1,3,33.3,0.00%,0,0,-
Derrick Walton Jr.,MIA ,23,7,3,100%,1,3,33.3,50,33.30%,0,1,0,66.70%,1,2,50
Bobby Brown,HOU ,33,2,2,100%,1,3,33.3,50,0.00%,0,0,-,100%,1,3,33.3
Jonathan Gibson,BOS ,30,1,1,100%,1,3,33.3,33.3,66.70%,1,2,50,33.30%,0,1,0
Jake Layman,POR ,24,6,3,100%,0,3,0,0,33.30%,0,1,0,66.70%,0,2,0
Marcus Georges-Hunt,MIN ,24,8,2,100%,0,3,0,0,0.00%,0,0,-,100%,0,3,0
Jordan Crawford,NOP ,29,2,2,100%,2,2,100,150,0.00%,0,0,-,100%,2,2,100
Walter Lemon Jr.,NOP ,25,3,2,100%,2,2,100,100,100%,2,2,100,0.00%,0,0,-
Adreian Payne,ORL ,27,1,1,100%,2,2,100,125,50.00%,1,1,100,50.00%,1,1,100
Derrick Williams,LAL ,27,1,1,100%,1,2,50,50,50.00%,1,1,100,50.00%,0,1,0
Zhou Qi,HOU ,22,1,1,100%,1,2,50,50,50.00%,1,1,100,50.00%,0,1,0
Wade Baldwin IV,POR ,22,3,2,100%,1,2,50,50,100%,1,2,50,0.00%,0,0,-
Julyan Stone,CHA ,29,7,2,100%,1,2,50,75,0.00%,0,0,-,100%,1,2,50
Brice Johnson,MEM ,23,2,1,100%,1,2,50,50,100%,1,2,50,0.00%,0,0,-
Gordon Hayward,BOS ,28,1,1,100%,1,2,50,50,50.00%,1,1,100,50.00%,0,1,0
Milton Doyle,BKN ,24,4,2,100%,1,2,50,50,50.00%,1,1,100,50.00%,0,1,0
James Webb III,BKN ,24,7,2,100%,0,2,0,0,0.00%,0,0,-,100%,0,2,0
Kyle Singler,OKC ,30,1,1,100%,0,2,0,0,100%,0,2,0,0.00%,0,0,-
Chinanu Onuaku,HOU ,21,1,1,100%,0,2,0,0,100%,0,2,0,0.00%,0,0,-
Larry Drew II,NOP ,28,2,1,100%,1,1,100,100,100%,1,1,100,0.00%,0,0,-
Joel Bolomboy,MIL ,24,2,1,100%,1,1,100,100,100%,1,1,100,0.00%,0,0,-
Alan Williams,PHX ,25,3,1,100%,1,1,100,100,100%,1,1,100,0.00%,0,0,-
Damian Jones,GSW ,22,1,1,100%,1,1,100,100,100%,1,1,100,0.00%,0,0,-
Scotty Hopson,DAL ,28,1,1,100%,0,1,0,0,100%,0,1,0,0.00%,0,0,-
Luol Deng,LAL ,33,1,1,100%,0,1,0,0,100%,0,1,0,0.00%,0,0,-
Josh Smith,NOP ,32,2,1,100%,0,1,0,0,100%,0,1,0,0.00%,0,0,-
Furkan Korkmaz,PHI ,20,1,1,100%,0,1,0,0,100%,0,1,0,0.00%,0,0,-
