name,team,age,gp,g,fgfreq,fgm,fga,fgp,efgp,2fgfreq,2fgm,2fga,2fgp,3pfreq,3pm,3pa,3pp
Russell Westbrook,OKC ,29,78,77,100%,184,377,48.8,51.6,79.30%,163,299,54.5,20.70%,21,78,26.9
Lou Williams,LAC ,31,79,79,100%,155,349,44.4,49.7,62.50%,118,218,54.1,37.50%,37,131,28.2
Anthony Davis,NOP ,25,73,73,100%,193,329,58.7,59.7,91.20%,186,300,62,8.80%,7,29,24.1
LaMarcus Aldridge,SAS ,32,75,75,100%,160,328,48.8,49.4,93.90%,156,308,50.6,6.10%,4,20,20
CJ McCollum,POR ,26,81,80,100%,147,325,45.2,51.1,66.80%,109,217,50.2,33.20%,38,108,35.2
LeBron James,CLE ,33,81,80,100%,194,324,59.9,64,76.20%,167,247,67.6,23.80%,27,77,35.1
Klay Thompson,GSW ,28,73,72,100%,152,321,47.4,55.6,60.10%,99,193,51.3,39.90%,53,128,41.4
Giannis Antetokounmpo,MIL ,23,74,73,100%,179,319,56.1,57.2,90.90%,172,290,59.3,9.10%,7,29,24.1
Karl-Anthony Towns,MIN ,22,82,79,100%,193,311,62.1,66.7,77.20%,164,240,68.3,22.80%,29,71,40.8
James Harden,HOU ,28,72,72,100%,153,311,49.2,58.4,48.90%,96,152,63.2,51.10%,57,159,35.8
Jordan Clarkson,CLE ,25,81,79,100%,153,306,50,55.7,68.30%,118,209,56.5,31.70%,35,97,36.1
Kemba Walker,CHA ,28,80,76,100%,152,285,53.3,62.6,56.10%,99,160,61.9,43.90%,53,125,42.4
Bradley Beal,WAS ,24,81,80,100%,152,285,53.3,58.6,70.50%,122,201,60.7,29.50%,30,84,35.7
Kevin Durant,GSW ,29,68,67,100%,155,280,55.4,61.4,70.40%,121,197,61.4,29.60%,34,83,41
Paul George,OKC ,28,78,76,100%,127,277,45.8,55.4,53.40%,74,148,50,46.60%,53,129,41.1
Kyle Kuzma,LAL ,22,76,75,100%,131,273,48,55.5,63.40%,90,173,52,36.60%,41,100,41
Buddy Hield,SAC ,24,78,76,100%,128,272,47.1,57.5,52.90%,71,144,49.3,47.10%,57,128,44.5
Donovan Mitchell,UTA ,21,78,77,100%,111,269,41.3,46.7,60.60%,82,163,50.3,39.40%,29,106,27.4
Eric Gordon,HOU ,29,69,68,100%,119,265,44.9,57.2,31.70%,54,84,64.3,68.30%,65,181,35.9
Dennis Schroder,ATL ,24,66,64,100%,134,258,51.9,55.2,77.50%,117,200,58.5,22.50%,17,58,29.3
Victor Oladipo,IND ,26,73,73,100%,137,256,53.5,58.6,74.20%,111,190,58.4,25.80%,26,66,39.4
Jamal Crawford,MIN ,38,80,79,100%,109,253,43.1,49.8,57.30%,75,145,51.7,42.70%,34,108,31.5
TJ Warren,PHX ,24,64,60,100%,133,251,53,54.2,92.00%,127,231,55,8.00%,6,20,30
Bobby Portis,CHI ,23,73,68,100%,129,247,52.2,56.7,72.10%,107,178,60.1,27.90%,22,69,31.9
DeMar DeRozan,TOR ,28,80,75,100%,122,247,49.4,52.2,83.00%,108,205,52.7,17.00%,14,42,33.3
Jrue Holiday,NOP ,27,80,76,100%,140,246,56.9,62,70.70%,115,174,66.1,29.30%,25,72,34.7
Carmelo Anthony,OKC ,33,75,70,100%,110,246,44.7,51.8,62.20%,75,153,49,37.80%,35,93,37.6
Will Barton,DEN ,27,80,77,100%,121,245,49.4,55.9,63.70%,89,156,57.1,36.30%,32,89,36
Frank Kaminsky,CHA ,25,79,77,100%,119,245,48.6,57.3,63.70%,76,156,48.7,36.30%,43,89,48.3
Dennis Smith Jr.,DAL ,20,69,68,100%,96,245,39.2,44.3,64.10%,71,157,45.2,35.90%,25,88,28.4
Lance Stephenson,IND ,27,81,78,100%,104,239,43.5,47.9,70.30%,83,168,49.4,29.70%,21,71,29.6
Jeremy Lamb,CHA ,25,80,77,100%,114,237,48.1,53.2,72.60%,90,172,52.3,27.40%,24,65,36.9
Ben Simmons,PHI ,21,80,77,100%,125,236,53,53,97.50%,125,230,54.3,2.50%,0,6,0
Harrison Barnes,DAL ,25,77,75,100%,106,236,44.9,50.2,73.70%,81,174,46.6,26.30%,25,62,40.3
Nikola Jokic,DEN ,23,74,67,100%,126,235,53.6,59.1,72.80%,100,171,58.5,27.20%,26,64,40.6
Goran Dragic,MIA ,32,74,73,100%,115,232,49.6,55.4,72.40%,88,168,52.4,27.60%,27,64,42.2
Kelly Oubre Jr.,WAS ,22,80,76,100%,99,231,42.9,50.2,55.00%,65,127,51.2,45.00%,34,104,32.7
Devin Booker,PHX ,21,54,54,100%,110,228,48.2,55.3,62.30%,78,142,54.9,37.70%,32,86,37.2
Joel Embiid,PHI ,24,61,59,100%,115,227,50.7,52.2,85.00%,108,193,56,15.00%,7,34,20.6
Damian Lillard,POR ,27,73,71,100%,116,225,51.6,60.9,52.00%,74,117,63.2,48.00%,42,108,38.9
Eric Bledsoe,MIL ,28,73,68,100%,112,225,49.8,55.6,63.60%,86,143,60.1,36.40%,26,82,31.7
JJ Redick,PHI ,33,69,67,100%,114,223,51.1,63.5,44.40%,59,99,59.6,55.60%,55,124,44.4
Dario Saric,PHI ,24,76,72,100%,103,223,46.2,54.3,54.30%,67,121,55.4,45.70%,36,102,35.3
Wayne Ellington,MIA ,30,76,69,100%,94,223,42.2,58.7,17.00%,20,38,52.6,83.00%,74,185,40
Kyrie Irving,BOS ,26,56,55,100%,111,221,50.2,58.1,57.00%,76,126,60.3,43.00%,35,95,36.8
Andrew Wiggins,MIN ,23,82,80,100%,100,220,45.5,50.2,72.70%,79,160,49.4,27.30%,21,60,35
Josh Jackson,PHX ,21,75,69,100%,104,219,47.5,51.1,71.20%,88,156,56.4,28.80%,16,63,25.4
Terry Rozier,BOS ,24,76,74,100%,87,219,39.7,48.6,48.90%,48,107,44.9,51.10%,39,112,34.8
Khris Middleton,MIL ,26,81,76,100%,111,217,51.2,57.6,66.40%,83,144,57.6,33.60%,28,73,38.4
Blake Griffin,DET ,29,57,56,100%,105,217,48.4,54.8,63.60%,77,138,55.8,36.40%,28,79,35.4
Jamal Murray,DEN ,21,77,75,100%,94,217,43.3,50.7,55.80%,62,121,51.2,44.20%,32,96,33.3
Chris Paul,HOU ,33,58,58,100%,103,215,47.9,54,56.70%,77,122,63.1,43.30%,26,93,28
Ricky Rubio,UTA ,27,76,70,100%,94,214,43.9,50.7,66.80%,65,143,45.5,33.20%,29,71,40.8
Marc Gasol,MEM ,33,73,68,100%,102,213,47.9,52.3,74.60%,83,159,52.2,25.40%,19,54,35.2
Otto Porter Jr.,WAS ,24,76,69,100%,112,212,52.8,59.4,67.90%,84,144,58.3,32.10%,28,68,41.2
Caris LeVert,BKN ,23,69,65,100%,96,212,45.3,51.2,67.90%,71,144,49.3,32.10%,25,68,36.8
Robert Covington,PHI ,27,79,74,100%,94,211,44.5,59.5,27.50%,31,58,53.4,72.50%,63,153,41.2
Kyle Lowry,TOR ,32,78,77,100%,96,208,46.2,61.1,31.70%,34,66,51.5,68.30%,62,142,43.7
Dirk Nowitzki,DAL ,39,77,75,100%,92,208,44.2,50.2,66.80%,67,139,48.2,33.20%,25,69,36.2
Ish Smith,DET ,29,80,75,100%,110,206,53.4,56.6,86.90%,97,179,54.2,13.10%,13,27,48.1
Thaddeus Young,IND ,29,79,72,100%,115,205,56.1,59.8,76.10%,100,156,64.1,23.90%,15,49,30.6
Shabazz Napier,POR ,26,72,66,100%,94,205,45.9,54.6,55.10%,58,113,51.3,44.90%,36,92,39.1
Dwyane Wade,MIA ,36,67,66,100%,103,204,50.5,52.5,86.80%,95,177,53.7,13.20%,8,27,29.6
Lauri Markkanen,CHI ,21,68,67,100%,88,204,43.1,50,53.90%,60,110,54.5,46.10%,28,94,29.8
Tyreke Evans,MEM ,28,52,49,100%,106,203,52.2,60.1,63.50%,74,129,57.4,36.50%,32,74,43.2
Julius Randle,LAL ,23,78,71,100%,118,201,58.7,59.2,94.00%,116,189,61.4,6.00%,2,12,16.7
Jimmy Butler,MIN ,28,59,57,100%,99,201,49.3,52.5,76.60%,86,154,55.8,23.40%,13,47,27.7
Michael Beasley,NYK ,29,66,63,100%,116,199,58.3,59.8,91.50%,110,182,60.4,8.50%,6,17,35.3
Mike Scott,WAS ,29,75,69,100%,116,198,58.6,64.4,74.20%,93,147,63.3,25.80%,23,51,45.1
Jayson Tatum,BOS ,20,77,70,100%,94,197,47.7,54.3,67.00%,68,132,51.5,33.00%,26,65,40
Jusuf Nurkic,POR ,23,77,71,100%,101,196,51.5,51.5,99.00%,101,194,52.1,1.00%,0,2,0
Tim Hardaway Jr.,NYK ,26,57,54,100%,97,195,49.7,57.9,53.30%,65,104,62.5,46.70%,32,91,35.2
Montrezl Harrell,LAC ,24,69,64,100%,141,194,72.7,72.7,99.50%,141,193,73.1,0.50%,0,1,0
Jeff Green,CLE ,31,77,70,100%,104,194,53.6,58.5,76.30%,85,148,57.4,23.70%,19,46,41.3
Tobias Harris,LAC ,25,80,78,100%,100,194,51.5,55.7,75.80%,84,147,57.1,24.20%,16,47,34
Taurean Prince,ATL ,24,80,69,100%,90,194,46.4,54.9,52.60%,57,102,55.9,47.40%,33,92,35.9
Marco Belinelli,PHI ,32,79,73,100%,85,194,43.8,52.8,51.00%,50,99,50.5,49.00%,35,95,36.8
Denzel Valentine,CHI ,24,77,70,100%,76,193,39.4,48.7,48.20%,40,93,43,51.80%,36,100,36
David West,GSW ,37,73,70,100%,115,192,59.9,60.2,98.40%,114,189,60.3,1.60%,1,3,33.3
J.J. Barea,DAL ,33,69,66,100%,96,191,50.3,60.2,56.50%,58,108,53.7,43.50%,38,83,45.8
Nikola Mirotic,NOP ,27,54,52,100%,80,191,41.9,51,47.60%,45,91,49.5,52.40%,35,100,35
Rodney Hood,CLE ,25,58,53,100%,91,189,48.1,59.8,49.70%,47,94,50,50.30%,44,95,46.3
Kristaps Porzingis,NYK ,22,47,46,100%,82,187,43.9,48.9,71.70%,63,134,47,28.30%,19,53,35.8
Yogi Ferrell,DAL ,25,82,75,100%,76,187,40.6,46.8,54.50%,53,102,52,45.50%,23,85,27.1
Domantas Sabonis,IND ,22,74,65,100%,102,186,54.8,56.5,95.20%,96,177,54.2,4.80%,6,9,66.7
Gary Harris,DEN ,23,65,63,100%,93,186,50,58.3,55.90%,62,104,59.6,44.10%,31,82,37.8
Patty Mills,SAS ,29,82,75,100%,70,185,37.8,49.2,34.10%,28,63,44.4,65.90%,42,122,34.4
Bojan Bogdanovic,IND ,29,79,74,100%,89,182,48.9,56.6,57.70%,61,105,58.1,42.30%,28,77,36.4
E'Twaun Moore,NOP ,29,79,71,100%,107,181,59.1,69.6,64.10%,69,116,59.5,35.90%,38,65,58.5
DeMarcus Cousins,NOP ,27,48,48,100%,105,181,58,63.5,71.30%,85,129,65.9,28.70%,20,52,38.5
Cory Joseph,IND ,26,81,76,100%,81,180,45,52.2,64.40%,55,116,47.4,35.60%,26,64,40.6
De'Aaron Fox,SAC ,20,69,65,100%,77,179,43,45.8,80.40%,67,144,46.5,19.60%,10,35,28.6
Stephen Curry,GSW ,30,50,49,100%,91,175,52,63.7,41.10%,50,72,69.4,58.90%,41,103,39.8
Rondae Hollis-Jefferson,BKN ,23,65,61,100%,88,174,50.6,51.4,94.30%,85,164,51.8,5.70%,3,10,30
Josh Richardson,MIA ,24,80,73,100%,87,174,50,59.5,55.20%,54,96,56.3,44.80%,33,78,42.3
Joe Ingles,UTA ,30,82,77,100%,81,174,46.6,62.1,30.50%,27,53,50.9,69.50%,54,121,44.6
Spencer Dinwiddie,BKN ,25,78,67,100%,74,173,42.8,52,46.80%,42,81,51.9,53.20%,32,92,34.8
Marcus Morris,BOS ,28,52,49,100%,70,170,41.2,47.4,61.20%,49,104,47.1,38.80%,21,66,31.8
Kelly Olynyk,MIA ,27,72,61,100%,87,169,51.5,59.8,52.70%,59,89,66.3,47.30%,28,80,35
Willie Cauley-Stein,SAC ,24,69,61,100%,94,167,56.3,56.3,97.60%,94,163,57.7,2.40%,0,4,0
Bogdan Bogdanovic,SAC ,25,75,65,100%,86,167,51.5,61.7,55.10%,52,92,56.5,44.90%,34,75,45.3
Courtney Lee,NYK ,32,69,64,100%,73,166,44,50.9,57.20%,50,95,52.6,42.80%,23,71,32.4
Andre Drummond,DET ,24,78,64,100%,92,165,55.8,55.8,99.40%,92,164,56.1,0.60%,0,1,0
Jeff Teague,MIN ,29,70,67,100%,79,165,47.9,54.8,69.70%,56,115,48.7,30.30%,23,50,46
Darius Miller,NOP ,28,76,70,100%,77,165,46.7,62.4,27.30%,25,45,55.6,72.70%,52,120,43.3
Clint Capela,HOU ,24,74,64,100%,119,163,73,73,100%,119,163,73,0.00%,0,0,-
Dillon Brooks,MEM ,22,81,72,100%,68,163,41.7,46,67.50%,54,110,49.1,32.50%,14,53,26.4
Fred VanVleet,TOR ,24,75,64,100%,89,162,54.9,66,54.90%,53,89,59.6,45.10%,36,73,49.3
Allen Crabbe,BKN ,26,73,70,100%,62,162,38.3,50,31.50%,24,51,47.1,68.50%,38,111,34.2
Kyle Korver,CLE ,37,73,66,100%,78,161,48.4,65.2,24.20%,24,39,61.5,75.80%,54,122,44.3
Shelvin Mack,ORL ,28,59,58,100%,75,161,46.6,51.6,69.60%,59,112,52.7,30.40%,16,49,32.7
DeMarre Carroll,BKN ,31,71,66,100%,70,161,43.5,52.5,52.20%,41,84,48.8,47.80%,29,77,37.7
CJ Miles,TOR ,31,69,63,100%,56,161,34.8,45.3,26.10%,22,42,52.4,73.90%,34,119,28.6
Steven Adams,OKC ,24,75,61,100%,98,160,61.3,61.3,99.40%,98,159,61.6,0.60%,0,1,0
Serge Ibaka,TOR ,28,76,66,100%,83,160,51.9,60,63.80%,57,102,55.9,36.30%,26,58,44.8
Nikola Vucevic,ORL ,27,55,53,100%,72,160,45,48.1,78.10%,62,125,49.6,21.90%,10,35,28.6
Jonathon Simmons,ORL ,28,69,64,100%,69,160,43.1,46.3,71.90%,59,115,51.3,28.10%,10,45,22.2
D'Angelo Russell,BKN ,22,47,45,100%,66,160,41.3,46.9,63.80%,48,102,47.1,36.30%,18,58,31
D.J. Augustin,ORL ,30,73,59,100%,75,158,47.5,57.3,52.50%,44,83,53,47.50%,31,75,41.3
Kentavious Caldwell-Pope,LAL ,25,71,64,100%,70,158,44.3,55.1,46.80%,36,74,48.6,53.20%,34,84,40.5
Troy Daniels,PHX ,26,74,62,100%,70,158,44.3,61.7,20.30%,15,32,46.9,79.70%,55,126,43.7
Austin Rivers,LAC ,25,61,56,100%,80,157,51,59.2,59.90%,54,94,57.4,40.10%,26,63,41.3
Kent Bazemore,ATL ,28,64,56,100%,64,157,40.8,49,54.10%,38,85,44.7,45.90%,26,72,36.1
Ian Clark,NOP ,27,64,56,100%,80,156,51.3,59,59.00%,56,92,60.9,41.00%,24,64,37.5
Raymond Felton,OKC ,33,80,73,100%,73,156,46.8,55.4,58.30%,46,91,50.5,41.70%,27,65,41.5
Evan Turner,POR ,29,79,66,100%,70,156,44.9,47.8,79.50%,61,124,49.2,20.50%,9,32,28.1
Joe Harris,BKN ,26,77,67,100%,86,155,55.5,69,43.20%,44,67,65.7,56.80%,42,88,47.7
Luke Kennard,DET ,21,64,61,100%,76,152,50,59.2,57.20%,48,87,55.2,42.80%,28,65,43.1
Doug McDermott,DAL ,26,77,63,100%,75,152,49.3,59.2,57.20%,45,87,51.7,42.80%,30,65,46.2
Jae Crowder,UTA ,27,78,66,100%,69,152,45.4,54.9,46.10%,40,70,57.1,53.90%,29,82,35.4
Shaun Livingston,GSW ,32,71,59,100%,81,151,53.6,53.6,98.00%,81,148,54.7,2.00%,0,3,0
Mario Hezonja,ORL ,23,68,60,100%,63,151,41.7,46.7,57.00%,48,86,55.8,43.00%,15,65,23.1
Kevin Love,CLE ,29,57,55,100%,76,150,50.7,61,51.30%,45,77,58.4,48.70%,31,73,42.5
Brook Lopez,LAL ,30,65,57,100%,71,150,47.3,53,61.30%,54,92,58.7,38.70%,17,58,29.3
Derrick Favors,UTA ,26,76,65,100%,89,149,59.7,60.7,88.60%,86,132,65.2,11.40%,3,17,17.6
Trey Lyles,DEN ,22,59,56,100%,74,149,49.7,57.7,54.40%,50,81,61.7,45.60%,24,68,35.3
Ersan Ilyasova,PHI ,31,67,62,100%,70,147,47.6,56.5,56.50%,44,83,53,43.50%,26,64,40.6
Tyler Johnson,MIA ,26,71,64,100%,63,147,42.9,51.4,52.40%,38,77,49.4,47.60%,25,70,35.7
Pascal Siakam,TOR ,24,77,68,100%,84,146,57.5,60.6,76.00%,75,111,67.6,24.00%,9,35,25.7
Danny Green,SAS ,30,70,62,100%,60,146,41.1,51.4,41.10%,30,60,50,58.90%,30,86,34.9
Reggie Jackson,DET ,28,45,43,100%,62,145,42.8,47.6,73.10%,48,106,45.3,26.90%,14,39,35.9
Delon Wright,TOR ,26,69,60,100%,74,143,51.7,57.7,70.60%,57,101,56.4,29.40%,17,42,40.5
Frank Ntilikina,NYK ,19,76,68,100%,65,143,45.5,51.4,72.00%,48,103,46.6,28.00%,17,40,42.5
Ryan Anderson,HOU ,30,66,57,100%,56,143,39.2,49.3,31.50%,27,45,60,68.50%,29,98,29.6
Jerian Grant,CHI ,25,71,63,100%,65,141,46.1,50.7,73.00%,52,103,50.5,27.00%,13,38,34.2
Wesley Matthews,DAL ,31,63,61,100%,62,141,44,51.8,51.80%,40,73,54.8,48.20%,22,68,32.4
Jodie Meeks,WAS ,30,76,61,100%,56,141,39.7,46.1,50.40%,38,71,53.5,49.60%,18,70,25.7
Anthony Tolliver,DET ,32,79,69,100%,64,140,45.7,60.4,25.00%,23,35,65.7,75.00%,41,105,39
Devin Harris,DEN ,35,69,62,100%,64,140,45.7,54.6,50.70%,39,71,54.9,49.30%,25,69,36.2
Draymond Green,GSW ,28,70,58,100%,65,139,46.8,52.5,56.10%,49,78,62.8,43.90%,16,61,26.2
Wilson Chandler,DEN ,31,74,58,100%,78,138,56.5,63.8,68.80%,58,95,61.1,31.20%,20,43,46.5
Dwight Howard,CHA ,32,78,63,100%,81,137,59.1,59.5,97.80%,80,134,59.7,2.20%,1,3,33.3
Emmanuel Mudiay,NYK ,22,57,51,100%,63,137,46,51.1,70.10%,49,96,51,29.90%,14,41,34.1
Trevor Ariza,HOU ,32,66,58,100%,56,137,40.9,52.6,32.10%,24,44,54.5,67.90%,32,93,34.4
Enes Kanter,NYK ,26,65,60,100%,87,135,64.4,64.4,99.30%,87,134,64.9,0.70%,0,1,0
Brandon Ingram,LAL ,20,59,49,100%,79,135,58.5,62.2,85.90%,69,116,59.5,14.10%,10,19,52.6
Aaron Gordon,ORL ,22,57,49,100%,58,135,43,50.4,61.50%,38,83,45.8,38.50%,20,52,38.5
Justin Holiday,CHI ,29,69,62,100%,54,135,40,50.7,40.70%,25,55,45.5,59.30%,29,80,36.3
Taj Gibson,MIN ,32,81,67,100%,89,134,66.4,66.8,94.80%,88,127,69.3,5.20%,1,7,14.3
Jerami Grant,OKC ,24,78,59,100%,86,134,64.2,67.5,76.90%,77,103,74.8,23.10%,9,31,29
Lonzo Ball,LAL ,20,51,48,100%,54,134,40.3,48.9,45.50%,31,61,50.8,54.50%,23,73,31.5
Al Horford,BOS ,31,69,57,100%,67,132,50.8,56.1,68.20%,53,90,58.9,31.80%,14,42,33.3
Dejounte Murray,SAS ,21,69,57,100%,62,132,47,47.3,92.40%,61,122,50,7.60%,1,10,10
Jonas Valanciunas,TOR ,26,74,54,100%,86,131,65.6,67.6,90.10%,81,118,68.6,9.90%,5,13,38.5
Jarell Martin,MEM ,24,67,51,100%,71,131,54.2,56.9,81.70%,64,107,59.8,18.30%,7,24,29.2
Reggie Bullock,DET ,27,59,54,100%,70,131,53.4,67.2,42.00%,34,55,61.8,58.00%,36,76,47.4
JR Smith,CLE ,32,80,58,100%,55,131,42,54.6,36.60%,22,48,45.8,63.40%,33,83,39.8
Kris Dunn,CHI ,24,52,50,100%,54,131,41.2,43.5,77.90%,48,102,47.1,22.10%,6,29,20.7
Malik Monk,CHA ,20,46,40,100%,48,131,36.6,45.8,48.10%,24,63,38.1,51.90%,24,68,35.3
Evan Fournier,ORL ,25,57,51,100%,60,129,46.5,53.5,61.20%,42,79,53.2,38.80%,18,50,36
Zach Randolph,SAC ,36,53,46,100%,76,128,59.4,64.8,82.00%,62,105,59,18.00%,14,23,60.9
Justise Winslow,MIA ,22,66,54,100%,58,128,45.3,50.8,70.30%,44,90,48.9,29.70%,14,38,36.8
Langston Galloway,DET ,26,53,53,100%,48,128,37.5,48.4,40.60%,20,52,38.5,59.40%,28,76,36.8
Elfrid Payton,PHX ,24,61,55,100%,65,127,51.2,53.5,89.00%,59,113,52.2,11.00%,6,14,42.9
Bryn Forbes,SAS ,24,68,54,100%,54,126,42.9,52.8,51.60%,29,65,44.6,48.40%,25,61,41
Pau Gasol,SAS ,37,77,67,100%,68,125,54.4,56.4,87.20%,63,109,57.8,12.80%,5,16,31.3
Malcolm Brogdon,MIL ,25,46,45,100%,63,125,50.4,56,67.20%,49,84,58.3,32.80%,14,41,34.1
JaMychal Green,MEM ,27,54,50,100%,54,125,43.2,47.2,74.40%,44,93,47.3,25.60%,10,32,31.3
John Wall,WAS ,27,40,39,100%,56,124,45.2,48.8,79.80%,47,99,47.5,20.20%,9,25,36
Avery Bradley,LAC ,27,46,42,100%,59,123,48,54.5,74.80%,43,92,46.7,25.20%,16,31,51.6
Tyler Ulis,PHX ,22,66,55,100%,55,123,44.7,50,70.70%,42,87,48.3,29.30%,13,36,36.1
Darren Collison,IND ,30,66,56,100%,56,122,45.9,50.8,74.60%,44,91,48.4,25.40%,12,31,38.7
Dwight Powell,DAL ,26,77,62,100%,81,121,66.9,69,84.30%,76,102,74.5,15.70%,5,19,26.3
John Collins,ATL ,20,72,57,100%,69,121,57,58.3,91.70%,66,111,59.5,8.30%,3,10,30
Markieff Morris,WAS ,28,71,60,100%,54,121,44.6,51.2,60.30%,38,73,52.1,39.70%,16,48,33.3
Manu Ginobili,SAS ,40,62,56,100%,52,121,43,50.4,53.70%,34,65,52.3,46.30%,18,56,32.1
Norman Powell,TOR ,25,57,44,100%,50,121,41.3,50.8,41.30%,27,50,54,58.70%,23,71,32.4
James Johnson,MIA ,31,70,53,100%,60,120,50,52.9,74.20%,53,89,59.6,25.80%,7,31,22.6
Kosta Koufos,SAC ,29,68,57,100%,72,119,60.5,60.5,100%,72,119,60.5,0.00%,0,0,-
John Henson,MIL ,27,73,58,100%,71,119,59.7,60.1,96.60%,70,115,60.9,3.40%,1,4,25
PJ Tucker,HOU ,33,82,65,100%,46,119,38.7,51.3,31.10%,16,37,43.2,68.90%,30,82,36.6
Tony Snell,MIL ,26,72,60,100%,58,117,49.6,64.5,38.50%,23,45,51.1,61.50%,35,72,48.6
Jaylen Brown,BOS ,21,66,56,100%,47,117,40.2,47.4,57.30%,30,67,44.8,42.70%,17,50,34
Hassan Whiteside,MIA ,28,54,48,100%,66,116,56.9,56.9,100%,66,116,56.9,0.00%,0,0,-
Marcus Smart,BOS ,24,51,44,100%,53,116,45.7,53.4,53.40%,35,62,56.5,46.60%,18,54,33.3
Al-Farouq Aminu,POR ,27,69,58,100%,47,115,40.9,52.6,37.40%,20,43,46.5,62.60%,27,72,37.5
Stanley Johnson,DET ,21,64,53,100%,45,115,39.1,45.2,59.10%,31,68,45.6,40.90%,14,47,29.8
DeAndre Jordan,LAC ,29,77,58,100%,87,113,77,77,100%,87,113,77,0.00%,0,0,-
Rudy Gay,SAS ,31,55,45,100%,64,113,56.6,59.3,82.30%,58,93,62.4,17.70%,6,20,30
Nicolas Batum,CHA ,29,64,58,100%,52,113,46,53.5,61.10%,35,69,50.7,38.90%,17,44,38.6
Vince Carter,SAC ,41,58,50,100%,43,113,38.1,47.3,46.00%,22,52,42.3,54.00%,21,61,34.4
Larry Nance Jr.,CLE ,25,64,51,100%,67,111,60.4,60.8,95.50%,66,106,62.3,4.50%,1,5,20
Nick Young,GSW ,32,65,50,100%,48,110,43.6,55.9,37.30%,21,41,51.2,62.70%,27,69,39.1
Garrett Temple,SAC ,32,61,47,100%,48,110,43.6,53.6,52.70%,26,58,44.8,47.30%,22,52,42.3
Frank Mason,SAC ,24,45,45,100%,43,110,39.1,42.7,74.50%,35,82,42.7,25.50%,8,28,28.6
Greg Monroe,BOS ,27,48,42,100%,65,109,59.6,59.6,100%,65,109,59.6,0.00%,0,0,-
Nemanja Bjelica,MIN ,30,65,51,100%,54,109,49.5,59.6,49.50%,32,54,59.3,50.50%,22,55,40
Gorgui Dieng,MIN ,28,79,55,100%,60,108,55.6,57.9,84.30%,55,91,60.4,15.70%,5,17,29.4
Myles Turner,IND ,22,63,49,100%,67,106,63.2,68.9,71.70%,55,76,72.4,28.30%,12,30,40
Robin Lopez,CHI ,30,58,50,100%,58,106,54.7,54.7,99.10%,58,105,55.2,0.90%,0,1,0
Gerald Green,HOU ,32,37,35,100%,50,106,47.2,63.2,21.70%,16,23,69.6,78.30%,34,83,41
Kyle Anderson,SAS ,24,74,54,100%,64,105,61,62.9,84.80%,60,89,67.4,15.20%,4,16,25
James Ennis III,DET ,27,69,53,100%,52,105,49.5,56.2,57.10%,38,60,63.3,42.90%,14,45,31.1
Milos Teodosic,LAC ,31,45,42,100%,47,104,45.2,61.1,28.80%,14,30,46.7,71.20%,33,74,44.6
Alec Burks,UTA ,26,56,48,100%,41,104,39.4,42.8,73.10%,34,76,44.7,26.90%,7,28,25
Marquese Chriss,PHX ,20,67,55,100%,50,103,48.5,56.3,59.20%,34,61,55.7,40.80%,16,42,38.1
Dragan Bender,PHX ,20,79,58,100%,45,103,43.7,56.3,32.00%,19,33,57.6,68.00%,26,70,37.1
Pat Connaughton,POR ,25,71,49,100%,38,103,36.9,46.6,35.00%,18,36,50,65.00%,20,67,29.9
Jakob Poeltl,TOR ,22,77,56,100%,75,102,73.5,73.5,100%,75,102,73.5,0.00%,0,0,-
George Hill,CLE ,32,62,49,100%,50,102,49,57.4,64.70%,33,66,50,35.30%,17,36,47.2
Jarrett Jack,NYK ,34,53,47,100%,43,101,42.6,44.1,78.20%,40,79,50.6,21.80%,3,22,13.6
Skal Labissiere,SAC ,22,47,38,100%,43,101,42.6,44.1,89.10%,40,90,44.4,10.90%,3,11,27.3
Josh Hart,LAL ,23,58,48,100%,46,100,46,56.5,43.00%,25,43,58.1,57.00%,21,57,36.8
Rudy Gobert,UTA ,25,55,47,100%,68,99,68.7,68.7,100%,68,99,68.7,0.00%,0,0,-
Mario Chalmers,MEM ,32,65,47,100%,52,99,52.5,59.1,60.60%,39,60,65,39.40%,13,39,33.3
Joe Johnson,HOU ,36,54,46,100%,43,99,43.4,49,60.60%,32,60,53.3,39.40%,11,39,28.2
Marreese Speights,ORL ,30,41,36,100%,40,99,40.4,52,37.40%,17,37,45.9,62.60%,23,62,37.1
Kyle O'Quinn,NYK ,28,75,53,100%,62,98,63.3,64.3,93.90%,60,92,65.2,6.10%,2,6,33.3
Michael Kidd-Gilchrist,CHA ,24,71,51,100%,53,98,54.1,54.1,100%,53,98,54.1,0.00%,0,0,-
David Nwaba,CHI ,25,69,58,100%,51,98,52,54.6,82.70%,46,81,56.8,17.30%,5,17,29.4
Trey Burke,NYK ,25,29,29,100%,49,98,50,54.1,75.50%,41,74,55.4,24.50%,8,24,33.3
Paul Millsap,DEN ,33,37,36,100%,40,98,40.8,46.9,64.30%,28,63,44.4,35.70%,12,35,34.3
Dewayne Dedmon,ATL ,28,60,47,100%,56,97,57.7,63.4,67.00%,45,65,69.2,33.00%,11,32,34.4
Tyus Jones,MIN ,22,80,56,100%,53,97,54.6,62.4,60.80%,38,59,64.4,39.20%,15,38,39.5
Andrew Harrison,MEM ,23,49,42,100%,43,96,44.8,49.5,65.60%,34,63,54,34.40%,9,33,27.3
Ed Davis,POR ,28,78,56,100%,60,94,63.8,63.8,98.90%,60,93,64.5,1.10%,0,1,0
Marvin Williams,CHA ,31,78,56,100%,38,93,40.9,47.3,44.10%,26,41,63.4,55.90%,12,52,23.1
Tyler Dorsey,ATL ,22,46,42,100%,30,93,32.3,39.8,45.20%,16,42,38.1,54.80%,14,51,27.5
Tomas Satoransky,WAS ,26,68,56,100%,50,91,54.9,61.5,68.10%,38,62,61.3,31.90%,12,29,41.4
Patrick Patterson,OKC ,29,80,51,100%,34,91,37.4,48.9,38.50%,13,35,37.1,61.50%,21,56,37.5
Jarrett Allen,BKN ,20,66,51,100%,62,90,68.9,69.4,95.60%,61,86,70.9,4.40%,1,4,25
Tony Parker,SAS ,36,55,44,100%,46,90,51.1,52.2,93.30%,44,84,52.4,6.70%,2,6,33.3
Jabari Parker,MIL ,23,30,30,100%,38,90,42.2,47.8,74.40%,28,67,41.8,25.60%,10,23,43.5
Isaiah Taylor,ATL ,23,63,47,100%,32,90,35.6,38.9,77.80%,26,70,37.1,22.20%,6,20,30
Rajon Rondo,NOP ,32,54,41,100%,47,87,54,59.2,75.90%,38,66,57.6,24.10%,9,21,42.9
Mike Muscala,ATL ,26,50,41,100%,39,87,44.8,54.6,39.10%,22,34,64.7,60.90%,17,53,32.1
Davis Bertans,SAS ,25,55,41,100%,33,87,37.9,51.1,24.10%,10,21,47.6,75.90%,23,66,34.8
Zach LaVine,CHI ,23,24,24,100%,42,86,48.8,53.5,66.30%,34,57,59.6,33.70%,8,29,27.6
Zach Collins,POR ,20,59,43,100%,33,86,38.4,42.4,62.80%,26,54,48.1,37.20%,7,32,21.9
Alex Abrines,OKC ,24,61,40,100%,31,86,36,47.1,25.60%,12,22,54.5,74.40%,19,64,29.7
Michael Carter-Williams,CHA ,26,52,46,100%,33,85,38.8,41.8,72.90%,28,62,45.2,27.10%,5,23,21.7
Bismack Biyombo,ORL ,25,81,54,100%,52,84,61.9,61.9,100%,52,84,61.9,0.00%,0,0,-
Trevor Booker,IND ,30,64,43,100%,49,84,58.3,58.3,91.70%,49,77,63.6,8.30%,0,7,0
Ben McLemore,MEM ,25,47,37,100%,39,84,46.4,54.2,54.80%,26,46,56.5,45.20%,13,38,34.2
Isaiah Thomas,LAL ,29,30,25,100%,35,84,41.7,51.8,45.20%,18,38,47.4,54.80%,17,46,37
Daniel Theis,BOS ,26,55,43,100%,51,83,61.4,65.7,72.30%,44,60,73.3,27.70%,7,23,30.4
Bam Adebayo,MIA ,20,61,44,100%,42,83,50.6,50.6,98.80%,42,82,51.2,1.20%,0,1,0
Wesley Johnson,LAC ,30,66,44,100%,36,83,43.4,50,56.60%,25,47,53.2,43.40%,11,36,30.6
Paul Zipser,CHI ,24,50,46,100%,33,82,40.2,51.8,45.10%,14,37,37.8,54.90%,19,45,42.2
Alex Len,PHX ,24,62,44,100%,54,81,66.7,67.3,97.50%,53,79,67.1,2.50%,1,2,50
Malcolm Delaney,ATL ,29,47,39,100%,30,81,37,43.2,60.50%,20,49,40.8,39.50%,10,32,31.3
Dante Cunningham,BKN ,31,67,49,100%,44,80,55,65.6,53.80%,27,43,62.8,46.30%,17,37,45.9
Quincy Acy,BKN ,27,61,50,100%,32,80,40,56.3,18.80%,6,15,40,81.30%,26,65,40
Mason Plumlee,DEN ,28,59,44,100%,48,78,61.5,61.5,100%,48,78,61.5,0.00%,0,0,-
Jonas Jerebko,UTA ,31,60,34,100%,39,78,50,62.2,46.20%,20,36,55.6,53.80%,19,42,45.2
Thon Maker,MIL ,21,60,40,100%,37,78,47.4,55.8,60.30%,24,47,51.1,39.70%,13,31,41.9
Sean Kilpatrick,CHI ,28,36,31,100%,28,77,36.4,43.5,46.80%,17,36,47.2,53.20%,11,41,26.8
Sam Dekker,LAC ,24,58,41,100%,46,76,60.5,63.2,81.60%,42,62,67.7,18.40%,4,14,28.6
Aron Baynes,BOS ,31,63,41,100%,35,75,46.7,46.7,97.30%,35,73,47.9,2.70%,0,2,0
Shabazz Muhammad,MIL ,25,35,31,100%,38,74,51.4,53.4,85.10%,35,63,55.6,14.90%,3,11,27.3
T.J. McConnell,PHI ,26,73,45,100%,37,74,50,52,83.80%,34,62,54.8,16.20%,3,12,25
Royce O'Neale,UTA ,24,57,41,100%,37,74,50,58.1,59.50%,25,44,56.8,40.50%,12,30,40
Andre Iguodala,GSW ,34,64,41,100%,36,74,48.6,52,71.60%,31,53,58.5,28.40%,5,21,23.8
Jerryd Bayless,PHI ,29,36,31,100%,33,74,44.6,55.4,40.50%,17,30,56.7,59.50%,16,44,36.4
Ian Mahinmi,WAS ,31,74,49,100%,50,73,68.5,68.5,100%,50,73,68.5,0.00%,0,0,-
Luc Mbah a Moute,HOU ,31,60,43,100%,39,72,54.2,64.6,48.60%,24,35,68.6,51.40%,15,37,40.5
Marcin Gortat,WAS ,34,69,46,100%,39,72,54.2,54.2,100%,39,72,54.2,0.00%,0,0,-
Justin Jackson,SAC ,23,51,42,100%,35,72,48.6,56.3,59.70%,24,43,55.8,40.30%,11,29,37.9
Corey Brewer,OKC ,32,61,39,100%,36,71,50.7,57,62.00%,27,44,61.4,38.00%,9,27,33.3
Dion Waiters,MIA ,26,28,28,100%,34,70,48.6,55,61.40%,25,43,58.1,38.60%,9,27,33.3
Shane Larkin,BOS ,25,39,34,100%,26,70,37.1,47.1,54.30%,12,38,31.6,45.70%,14,32,43.8
Jameer Nelson,DET ,36,49,42,100%,32,69,46.4,55.1,46.40%,20,32,62.5,53.60%,12,37,32.4
Mike James,NOP ,27,31,27,100%,32,69,46.4,50.7,65.20%,26,45,57.8,34.80%,6,24,25
Timothe Luwawu-Cabarrot,PHI ,23,40,32,100%,23,68,33.8,45.6,29.40%,7,20,35,70.60%,16,48,33.3
Maurice Harkless,POR ,25,50,35,100%,36,65,55.4,63.8,55.40%,25,36,69.4,44.60%,11,29,37.9
Channing Frye,LAL ,35,40,36,100%,34,65,52.3,60,49.20%,24,32,75,50.80%,10,33,30.3
OG Anunoby,TOR ,20,62,41,100%,31,64,48.4,57,37.50%,20,24,83.3,62.50%,11,40,27.5
Deyonta Davis,MEM ,21,55,34,100%,41,63,65.1,65.1,100%,41,63,65.1,0.00%,0,0,-
Derrick Rose,MIN ,29,25,22,100%,29,63,46,48.4,85.70%,26,54,48.1,14.30%,3,9,33.3
Wes Iwundu,ORL ,23,54,35,100%,29,63,46,49.2,79.40%,25,50,50,20.60%,4,13,30.8
Wayne Selden,MEM ,23,30,24,100%,28,63,44.4,52.4,58.70%,18,37,48.6,41.30%,10,26,38.5
Kenneth Faried,DEN ,28,32,25,100%,44,62,71,71,100%,44,62,71,0.00%,0,0,-
Semi Ojeleye,BOS ,23,60,36,100%,21,62,33.9,42.7,32.30%,10,20,50,67.70%,11,42,26.2
Chandler Parsons,MEM ,29,36,28,100%,33,61,54.1,69.7,34.40%,14,21,66.7,65.60%,19,40,47.5
Danilo Gallinari,LAC ,29,21,21,100%,28,61,45.9,52.5,50.80%,20,31,64.5,49.20%,8,30,26.7
Thabo Sefolosha,UTA ,34,38,31,100%,38,60,63.3,73.3,63.30%,26,38,68.4,36.70%,12,22,54.5
Arron Afflalo,ORL ,32,43,36,100%,25,60,41.7,50,53.30%,15,32,46.9,46.70%,10,28,35.7
Joe Young,IND ,25,39,32,100%,27,59,45.8,52.5,67.80%,19,40,47.5,32.20%,8,19,42.1
Malik Beasley,DEN ,21,39,30,100%,26,59,44.1,51.7,44.10%,17,26,65.4,55.90%,9,33,27.3
Terrence Ross,ORL ,27,24,21,100%,23,59,39,47.5,52.50%,13,31,41.9,47.50%,10,28,35.7
Al Jefferson,IND ,33,31,25,100%,42,58,72.4,72.4,100%,42,58,72.4,0.00%,0,0,-
Treveon Graham,CHA ,24,57,35,100%,35,57,61.4,74.6,59.60%,20,34,58.8,40.40%,15,23,65.2
Johnny O'Bryant III,CHA ,24,31,27,100%,26,57,45.6,52.6,66.70%,18,38,47.4,33.30%,8,19,42.1
Maxi Kleber,DAL ,26,48,28,100%,35,56,62.5,70.5,57.10%,26,32,81.3,42.90%,9,24,37.5
Tyler Zeller,MIL ,28,41,31,100%,32,56,57.1,59.8,89.30%,29,50,58,10.70%,3,6,50
Amir Johnson,PHI ,31,73,38,100%,33,55,60,63.6,83.60%,29,46,63,16.40%,4,9,44.4
Tristan Thompson,CLE ,27,51,33,100%,30,54,55.6,55.6,100%,30,54,55.6,0.00%,0,0,-
Patrick McCaw,GSW ,22,48,26,100%,27,53,50.9,54.7,60.40%,23,32,71.9,39.60%,4,21,19
Jawun Evans,LAC ,21,42,27,100%,21,53,39.6,42.5,77.40%,18,41,43.9,22.60%,3,12,25
Sterling Brown,MIL ,23,39,33,100%,20,53,37.7,45.3,47.20%,12,25,48,52.80%,8,28,28.6
Dwayne Bacon,CHA ,22,33,23,100%,18,53,34,34.9,81.10%,17,43,39.5,18.90%,1,10,10
Tyson Chandler,PHX ,35,45,27,100%,31,52,59.6,59.6,100%,31,52,59.6,0.00%,0,0,-
Jason Terry,MIL ,40,42,26,100%,26,51,51,68.6,25.50%,8,13,61.5,74.50%,18,38,47.4
Cameron Payne,CHI ,23,25,23,100%,21,51,41.2,48,54.90%,14,28,50,45.10%,7,23,30.4
Tyler Ennis,LAL ,23,31,21,100%,20,51,39.2,43.1,66.70%,16,34,47.1,33.30%,4,17,23.5
Richaun Holmes,PHI ,24,31,22,100%,38,50,76,78,90.00%,36,45,80,10.00%,2,5,40
Omri Casspi,GSW ,29,37,28,100%,33,50,66,69,88.00%,30,44,68.2,12.00%,3,6,50
Lance Thomas,NYK ,30,61,30,100%,18,50,36,48,38.00%,6,19,31.6,62.00%,12,31,38.7
Luke Babbitt,MIA ,28,33,29,100%,18,49,36.7,50,24.50%,5,12,41.7,75.50%,13,37,35.1
Jonathan Isaac,ORL ,20,27,22,100%,14,49,28.6,31.6,69.40%,11,34,32.4,30.60%,3,15,20
Tim Frazier,WAS ,27,44,30,100%,20,48,41.7,47.9,56.30%,14,27,51.9,43.80%,6,21,28.6
Cody Zeller,CHA ,25,33,25,100%,33,47,70.2,70.2,100%,33,47,70.2,0.00%,0,0,-
Cheick Diallo,NOP ,21,34,24,100%,33,47,70.2,70.2,100%,33,47,70.2,0.00%,0,0,-
Kawhi Leonard,SAS ,26,9,9,100%,24,46,52.2,58.7,65.20%,18,30,60,34.80%,6,16,37.5
Josh Huestis,OKC ,26,50,29,100%,14,46,30.4,35.9,43.50%,9,20,45,56.50%,5,26,19.2
Nene,HOU ,35,42,24,100%,30,45,66.7,66.7,100%,30,45,66.7,0.00%,0,0,-
Jahlil Okafor,BKN ,22,24,20,100%,29,45,64.4,64.4,97.80%,29,44,65.9,2.20%,0,1,0
Noah Vonleh,CHI ,22,39,24,100%,27,45,60,66.7,66.70%,21,30,70,33.30%,6,15,40
Cristiano Felicio,CHI ,25,48,28,100%,26,45,57.8,57.8,97.80%,26,44,59.1,2.20%,0,1,0
Dwight Buycks,DET ,29,22,21,100%,23,45,51.1,52.2,84.40%,22,38,57.9,15.60%,1,7,14.3
Quinn Cook,GSW ,25,22,20,100%,21,45,46.7,54.4,62.20%,14,28,50,37.80%,7,17,41.2
TJ Leaf,IND ,21,42,28,100%,27,44,61.4,72.7,63.60%,17,28,60.7,36.40%,10,16,62.5
Justin Anderson,PHI ,24,29,23,100%,22,44,50,59.1,45.50%,14,20,70,54.50%,8,24,33.3
Tyler Cavanaugh,ATL ,24,30,22,100%,21,43,48.8,60.5,34.90%,11,15,73.3,65.10%,10,28,35.7
Antonio Blakeney,CHI ,21,15,14,100%,17,43,39.5,45.3,60.50%,12,26,46.2,39.50%,5,17,29.4
Willy Hernangomez,CHA ,24,27,17,100%,26,42,61.9,63.1,95.20%,25,40,62.5,4.80%,1,2,50
Sindarius Thornwell,LAC ,23,57,28,100%,24,42,57.1,61.9,71.40%,20,30,66.7,28.60%,4,12,33.3
Tyrone Wallace,LAC ,23,30,21,100%,16,42,38.1,41.7,73.80%,13,31,41.9,26.20%,3,11,27.3
Kobi Simmons,MEM ,20,28,21,100%,17,41,41.5,42.7,87.80%,16,36,44.4,12.20%,1,5,20
Luke Kornet,NYK ,22,16,14,100%,15,41,36.6,52.4,26.80%,2,11,18.2,73.20%,13,30,43.3
Jared Dudley,PHX ,32,41,31,100%,13,41,31.7,42.7,26.80%,4,11,36.4,73.20%,9,30,30
Ivan Rabb,MEM ,21,25,20,100%,29,40,72.5,72.5,100%,29,40,72.5,0.00%,0,0,-
Boban Marjanovic,LAC ,29,24,16,100%,21,40,52.5,52.5,100%,21,40,52.5,0.00%,0,0,-
Mike Conley,MEM ,30,12,12,100%,14,40,35,42.5,55.00%,8,22,36.4,45.00%,6,18,33.3
Jordan Bell,GSW ,23,40,24,100%,27,39,69.2,69.2,100%,27,39,69.2,0.00%,0,0,-
Eric Moreland,DET ,26,58,23,100%,21,39,53.8,53.8,100%,21,39,53.8,0.00%,0,0,-
Jose Calderon,CLE ,36,35,27,100%,18,39,46.2,59,33.30%,8,13,61.5,66.70%,10,26,38.5
Abdel Nader,BOS ,24,27,20,100%,17,39,43.6,53.8,48.70%,9,19,47.4,51.30%,8,20,40
Kevon Looney,GSW ,22,43,24,100%,27,38,71.1,71.1,100%,27,38,71.1,0.00%,0,0,-
Damion Lee,ATL ,25,15,14,100%,20,38,52.6,64.5,50.00%,11,19,57.9,50.00%,9,19,47.4
Salah Mejri,DAL ,31,42,24,100%,29,37,78.4,78.4,100%,29,37,78.4,0.00%,0,0,-
Khem Birch,ORL ,25,34,20,100%,21,37,56.8,56.8,100%,21,37,56.8,0.00%,0,0,-
Raul Neto,UTA ,26,33,22,100%,20,37,54.1,60.8,70.30%,15,26,57.7,29.70%,5,11,45.5
C.J. Williams,LAC ,28,28,21,100%,16,37,43.2,47.3,62.20%,13,23,56.5,37.80%,3,14,21.4
Henry Ellenson,DET ,21,16,12,100%,16,37,43.2,51.4,56.80%,10,21,47.6,43.20%,6,16,37.5
Rodney Purvis,ORL ,24,16,14,100%,11,36,30.6,36.1,47.20%,7,17,41.2,52.80%,4,19,21.1
Miles Plumlee,ATL ,29,44,27,100%,22,35,62.9,62.9,100%,22,35,62.9,0.00%,0,0,-
Andre Roberson,OKC ,26,34,20,100%,15,35,42.9,44.3,74.30%,14,26,53.8,25.70%,1,9,11.1
Damyean Dotson,NYK ,24,17,14,100%,17,34,50,55.9,61.80%,13,21,61.9,38.20%,4,13,30.8
DeAndre' Bembry,ATL ,23,25,21,100%,16,34,47.1,48.5,76.50%,15,26,57.7,23.50%,1,8,12.5
Isaiah Canaan,PHX ,27,18,12,100%,12,34,35.3,47.1,44.10%,4,15,26.7,55.90%,8,19,42.1
Matthew Dellavedova,MIL ,27,32,19,100%,11,34,32.4,41.2,55.90%,5,19,26.3,44.10%,6,15,40
Willie Reed,DET ,28,31,21,100%,25,33,75.8,77.3,97.00%,24,32,75,3.00%,1,1,100
Terrance Ferguson,OKC ,20,38,21,100%,14,33,42.4,57.6,18.20%,4,6,66.7,81.80%,10,27,37
Dorian Finney-Smith,DAL ,25,21,13,100%,12,33,36.4,42.4,42.40%,8,14,57.1,57.60%,4,19,21.1
Shaquille Harrison,PHX ,24,18,16,100%,18,32,56.3,59.4,78.10%,16,25,64,21.90%,2,7,28.6
Travis Wear,LAL ,27,14,13,100%,13,32,40.6,54.7,25.00%,4,8,50,75.00%,9,24,37.5
Cedi Osman,CLE ,23,35,19,100%,12,32,37.5,40.6,50.00%,10,16,62.5,50.00%,2,16,12.5
Troy Williams,NYK ,23,14,11,100%,17,31,54.8,62.9,67.70%,12,21,57.1,32.30%,5,10,50
Joffrey Lauvergne,SAS ,26,28,19,100%,19,30,63.3,63.3,90.00%,19,27,70.4,10.00%,0,3,0
Ekpe Udoh,UTA ,31,50,21,100%,16,30,53.3,53.3,100%,16,30,53.3,0.00%,0,0,-
Alex Caruso,LAL ,24,30,17,100%,14,30,46.7,50,66.70%,12,20,60,33.30%,2,10,20
Torrey Craig,DEN ,27,34,17,100%,15,29,51.7,58.6,48.30%,11,14,78.6,51.70%,4,15,26.7
Nik Stauskas,BKN ,24,24,14,100%,15,29,51.7,65.5,44.80%,7,13,53.8,55.20%,8,16,50
Jason Smith,WAS ,32,15,11,100%,10,29,34.5,36.2,58.60%,9,17,52.9,41.40%,1,12,8.3
Brandan Wright,HOU ,30,24,17,100%,21,28,75,75,100%,21,28,75,0.00%,0,0,-
MarShon Brooks,MEM ,29,7,6,100%,16,28,57.1,64.3,71.40%,12,20,60,28.60%,4,8,50
Tony Allen,NOP ,36,21,14,100%,12,28,42.9,46.4,75.00%,10,21,47.6,25.00%,2,7,28.6
Ivica Zubac,LAL ,21,24,17,100%,17,27,63,63,100%,17,27,63,0.00%,0,0,-
DeAndre Liggins,NOP ,30,38,20,100%,12,27,44.4,57.4,40.70%,5,11,45.5,59.30%,7,16,43.8
Timofey Mozgov,BKN ,31,20,16,100%,19,26,73.1,76.9,84.60%,17,22,77.3,15.40%,2,4,50
Meyers Leonard,POR ,26,17,12,100%,13,26,50,57.7,57.70%,9,15,60,42.30%,4,11,36.4
Myke Henry,MEM ,25,16,12,100%,11,26,42.3,53.8,30.80%,5,8,62.5,69.20%,6,18,33.3
Ramon Sessions,WAS ,32,17,15,100%,10,25,40,44,76.00%,8,19,42.1,24.00%,2,6,33.3
Danuel House,PHX ,24,19,15,100%,9,25,36,40,44.00%,7,11,63.6,56.00%,2,14,14.3
Jordan Mickey,MIA ,23,12,11,100%,15,24,62.5,64.6,70.80%,14,17,82.4,29.20%,1,7,14.3
Kay Felder,DET ,23,8,7,100%,12,23,52.2,58.7,73.90%,9,17,52.9,26.10%,3,6,50
Isaiah Hicks,NYK ,23,16,12,100%,11,23,47.8,50,78.30%,10,18,55.6,21.70%,1,5,20
Rashad Vaughn,ORL ,21,13,11,100%,9,23,39.1,52.2,34.80%,3,8,37.5,65.20%,6,15,40
Aaron Harrison,DAL ,23,9,8,100%,7,23,30.4,37,43.50%,4,10,40,56.50%,3,13,23.1
Dante Exum,UTA ,22,14,12,100%,13,22,59.1,61.4,86.40%,12,19,63.2,13.60%,1,3,33.3
Malachi Richardson,TOR ,22,14,12,100%,9,22,40.9,50,40.90%,5,9,55.6,59.10%,4,13,30.8
Glenn Robinson III,IND ,24,19,15,100%,13,21,61.9,76.2,52.40%,7,11,63.6,47.60%,6,10,60
Brandon Jennings,MIL ,28,11,9,100%,11,21,52.4,61.9,47.60%,7,10,70,52.40%,4,11,36.4
Nerlens Noel,DAL ,24,23,16,100%,12,20,60,60,100%,12,20,60,0.00%,0,0,-
Markelle Fultz,PHI ,20,14,10,100%,10,20,50,50,100%,10,20,50,0.00%,0,0,-
Andrew White III,ATL ,24,11,9,100%,4,20,20,27.5,45.00%,1,9,11.1,55.00%,3,11,27.3
Tarik Black,HOU ,26,23,8,100%,12,19,63.2,63.2,100%,12,19,63.2,0.00%,0,0,-
JaKarr Sampson,SAC ,25,16,11,100%,9,19,47.4,50,78.90%,8,15,53.3,21.10%,1,4,25
Rodney McGruder,MIA ,26,13,8,100%,8,19,42.1,50,57.90%,5,11,45.5,42.10%,3,8,37.5
Ron Baker,NYK ,25,19,11,100%,6,19,31.6,39.5,36.80%,3,7,42.9,63.20%,3,12,25
Kyle Collinsworth,DAL ,26,25,11,100%,12,18,66.7,75,72.20%,9,13,69.2,27.80%,3,5,60
Jamel Artis,ORL ,25,10,8,100%,7,18,38.9,44.4,55.60%,5,10,50,44.40%,2,8,25
Brandon Paul,SAS ,27,31,14,100%,6,18,33.3,41.7,55.60%,3,10,30,44.40%,3,8,37.5
Davon Reed,PHX ,22,11,8,100%,5,18,27.8,36.1,38.90%,2,7,28.6,61.10%,3,11,27.3
Patrick Beverley,LAC ,29,11,7,100%,11,17,64.7,70.6,76.50%,9,13,69.2,23.50%,2,4,50
Guerschon Yabusele,BOS ,22,13,10,100%,8,17,47.1,64.7,23.50%,2,4,50,76.50%,6,13,46.2
Caleb Swanigan,POR ,21,12,9,100%,4,17,23.5,23.5,76.50%,4,13,30.8,23.50%,0,4,0
Lucas Nogueira,TOR ,25,25,10,100%,12,16,75,81.3,75.00%,10,12,83.3,25.00%,2,4,50
Gary Payton II,LAL ,25,8,7,100%,9,16,56.3,59.4,62.50%,8,10,80,37.50%,1,6,16.7
Aaron Brooks,MIN ,33,11,10,100%,7,15,46.7,53.3,53.30%,5,8,62.5,46.70%,2,7,28.6
Mirza Teletovic,MIL ,32,9,7,100%,6,15,40,50,46.70%,3,7,42.9,53.30%,3,8,37.5
Ante Zizic,CLE ,21,10,9,100%,11,14,78.6,78.6,100%,11,14,78.6,0.00%,0,0,-
Briante Weber,MEM ,25,12,8,100%,6,13,46.2,50,76.90%,5,10,50,23.10%,1,3,33.3
Johnathan Motley,DAL ,23,5,5,100%,8,12,66.7,66.7,100%,8,12,66.7,0.00%,0,0,-
John Holland,CLE ,29,8,5,100%,5,12,41.7,50,41.70%,3,5,60,58.30%,2,7,28.6
Jabari Bird,BOS ,23,4,3,100%,10,11,90.9,90.9,90.90%,10,10,100,9.10%,0,1,0
Derrick Walton Jr.,MIA ,23,10,7,100%,7,11,63.6,90.9,9.10%,1,1,100,90.90%,6,10,60
Isaiah Whitehead,BKN ,23,7,6,100%,6,11,54.5,59.1,72.70%,5,8,62.5,27.30%,1,3,33.3
Jamil Wilson,LAC ,27,9,7,100%,5,11,45.5,63.6,18.20%,1,2,50,81.80%,4,9,44.4
Marcus Georges-Hunt,MIN ,24,20,8,100%,4,11,36.4,40.9,72.70%,3,8,37.5,27.30%,1,3,33.3
Lorenzo Brown,TOR ,27,10,6,100%,4,11,36.4,40.9,63.60%,3,7,42.9,36.40%,1,4,25
Quincy Pondexter,CHI ,30,11,6,100%,2,11,18.2,18.2,54.50%,2,6,33.3,45.50%,0,5,0
Zaza Pachulia,GSW ,34,12,6,100%,8,10,80,80,100%,8,10,80,0.00%,0,0,-
Andrew Bogut,LAL ,33,14,8,100%,6,10,60,60,100%,6,10,60,0.00%,0,0,-
Ryan Arcidiacono,CHI ,24,18,8,100%,6,10,60,75,30.00%,3,3,100,70.00%,3,7,42.9
Josh Magette,ATL ,28,13,7,100%,5,10,50,65,40.00%,2,4,50,60.00%,3,6,50
Jalen Jones,DAL ,25,4,4,100%,5,10,50,55,70.00%,4,7,57.1,30.00%,1,3,33.3
Juancho Hernangomez,DEN ,22,13,7,100%,5,10,50,60,30.00%,3,3,100,70.00%,2,7,28.6
Georgios Papagiannis,POR ,20,6,5,100%,5,10,50,50,100%,5,10,50,0.00%,0,0,-
Solomon Hill,NOP ,27,11,6,100%,4,10,40,50,40.00%,2,4,50,60.00%,2,6,33.3
Malcolm Miller,TOR ,25,6,5,100%,7,9,77.8,105.6,22.20%,2,2,100,77.80%,5,7,71.4
Darrell Arthur,DEN ,30,13,7,100%,6,9,66.7,77.8,44.40%,4,4,100,55.60%,2,5,40
Wade Baldwin IV,POR ,22,4,4,100%,6,9,66.7,83.3,66.70%,3,6,50,33.30%,3,3,100
Derrick Jones Jr.,MIA ,21,10,7,100%,5,9,55.6,61.1,88.90%,4,8,50,11.10%,1,1,100
Damien Wilkins,IND ,38,8,5,100%,4,9,44.4,55.6,33.30%,2,3,66.7,66.70%,2,6,33.3
Richard Jefferson,DEN ,37,10,7,100%,4,9,44.4,44.4,77.80%,4,7,57.1,22.20%,0,2,0
Alec Peters,PHX ,23,7,4,100%,4,9,44.4,61.1,33.30%,1,3,33.3,66.70%,3,6,50
Iman Shumpert,SAC ,27,12,5,100%,3,9,33.3,33.3,66.70%,3,6,50,33.30%,0,3,0
Antonius Cleveland,ATL ,24,11,7,100%,1,9,11.1,11.1,88.90%,1,8,12.5,11.10%,0,1,0
Josh Gray,PHX ,24,4,3,100%,3,8,37.5,37.5,87.50%,3,7,42.9,12.50%,0,1,0
Jon Leuer,DET ,29,8,6,100%,2,8,25,25,75.00%,2,6,33.3,25.00%,0,2,0
Bruno Caboclo,SAC ,22,4,4,100%,2,8,25,31.3,50.00%,1,4,25,50.00%,1,4,25
Xavier Rathan-Mayes,MEM ,24,5,4,100%,2,8,25,25,87.50%,2,7,28.6,12.50%,0,1,0
Milton Doyle,BKN ,24,6,4,100%,1,8,12.5,12.5,50.00%,1,4,25,50.00%,0,4,0
Derrick White,SAS ,23,6,4,100%,4,7,57.1,64.3,71.40%,3,5,60,28.60%,1,2,50
JaVale McGee,GSW ,30,5,4,100%,4,7,57.1,57.1,100%,4,7,57.1,0.00%,0,0,-
Emeka Okafor,NOP ,35,9,4,100%,3,7,42.9,42.9,100%,3,7,42.9,0.00%,0,0,-
Omari Johnson,MEM ,29,4,4,100%,3,7,42.9,57.1,42.90%,1,3,33.3,57.10%,2,4,50
Jordan Crawford,NOP ,29,3,3,100%,3,7,42.9,57.1,57.10%,1,4,25,42.90%,2,3,66.7
Jaylen Morris,ATL ,22,6,3,100%,3,6,50,58.3,50.00%,2,3,66.7,50.00%,1,3,33.3
James Webb III,BKN ,24,7,5,100%,2,6,33.3,50,0.00%,0,0,-,100%,2,6,33.3
Bobby Brown,HOU ,33,3,2,100%,2,6,33.3,33.3,50.00%,2,3,66.7,50.00%,0,3,0
Brice Johnson,MEM ,23,3,2,100%,2,6,33.3,33.3,100%,2,6,33.3,0.00%,0,0,-
Alex Poythress,IND ,24,8,4,100%,2,6,33.3,33.3,83.30%,2,5,40,16.70%,0,1,0
Alan Williams,PHX ,25,4,3,100%,3,5,60,60,100%,3,5,60,0.00%,0,0,-
Jeremy Lin,BKN ,29,1,1,100%,3,5,60,70,80.00%,2,4,50,20.00%,1,1,100
Julyan Stone,CHA ,29,7,4,100%,2,5,40,60,0.00%,0,0,-,100%,2,5,40
Thomas Bryant,LAL ,20,2,2,100%,2,5,40,40,80.00%,2,4,50,20.00%,0,1,0
Gian Clavell,DAL ,24,4,3,100%,1,5,20,30,40.00%,0,2,0,60.00%,1,3,33.3
Nigel Hayes,SAC ,23,5,4,100%,1,5,20,20,60.00%,1,3,33.3,40.00%,0,2,0
Kadeem Allen,BOS ,25,5,3,100%,0,5,0,0,20.00%,0,1,0,80.00%,0,4,0
Omer Asik,CHI ,31,12,3,100%,3,4,75,75,100%,3,4,75,0.00%,0,0,-
Andre Ingram,LAL ,32,2,2,100%,3,4,75,100,50.00%,1,2,50,50.00%,2,2,100
Jack Cooley,SAC ,27,6,4,100%,3,4,75,75,100%,3,4,75,0.00%,0,0,-
Walter Lemon Jr.,NOP ,25,4,3,100%,2,4,50,62.5,75.00%,1,3,33.3,25.00%,1,1,100
Joakim Noah,NYK ,33,3,3,100%,1,4,25,25,100%,1,4,25,0.00%,0,0,-
Larry Drew II,NOP ,28,5,3,100%,1,4,25,37.5,0.00%,0,0,-,100%,1,4,25
Jake Layman,POR ,24,4,2,100%,0,4,0,0,75.00%,0,3,0,25.00%,0,1,0
Jonathan Gibson,BOS ,30,1,1,100%,2,3,66.7,83.3,66.70%,1,2,50,33.30%,1,1,100
Dakari Johnson,OKC ,22,6,2,100%,2,3,66.7,66.7,100%,2,3,66.7,0.00%,0,0,-
Joel Bolomboy,MIL ,24,2,2,100%,1,3,33.3,33.3,66.70%,1,2,50,33.30%,0,1,0
Marquis Teague,MEM ,25,3,2,100%,1,3,33.3,33.3,66.70%,1,2,50,33.30%,0,1,0
Darrun Hilliard,SAS ,25,7,3,100%,0,3,0,0,33.30%,0,1,0,66.70%,0,2,0
Zhou Qi,HOU ,22,3,2,100%,0,3,0,0,0.00%,0,0,-,100%,0,3,0
Damian Jones,GSW ,22,4,2,100%,1,2,50,50,100%,1,2,50,0.00%,0,0,-
Demetrius Jackson,PHI ,23,4,1,100%,1,2,50,50,50.00%,1,1,100,50.00%,0,1,0
Furkan Korkmaz,PHI ,20,1,1,100%,1,2,50,75,0.00%,0,0,-,100%,1,2,50
London Perrantes,CLE ,23,1,1,100%,1,2,50,50,100%,1,2,50,0.00%,0,0,-
D.J. Wilson,MIL ,22,3,2,100%,0,2,0,0,0.00%,0,0,-,100%,0,2,0
Vander Blue,LAL ,25,4,2,100%,0,2,0,0,50.00%,0,1,0,50.00%,0,1,0
Xavier Munford,MIL ,25,1,1,100%,1,1,100,100,100%,1,1,100,0.00%,0,0,-
Adreian Payne,ORL ,27,2,1,100%,1,1,100,100,100%,1,1,100,0.00%,0,0,-
Chinanu Onuaku,HOU ,21,1,1,100%,1,1,100,100,100%,1,1,100,0.00%,0,0,-
Cole Aldrich,MIN ,29,1,1,100%,0,1,0,0,100%,0,1,0,0.00%,0,0,-
Jarell Eddie,CHI ,26,1,1,100%,0,1,0,0,0.00%,0,0,-,100%,0,1,0
Josh McRoberts,DAL ,31,1,1,100%,0,1,0,0,0.00%,0,0,-,100%,0,1,0
Udonis Haslem,MIA ,37,4,1,100%,0,1,0,0,100%,0,1,0,0.00%,0,0,-
Matt Costello,SAS ,24,1,1,100%,0,1,0,0,100%,0,1,0,0.00%,0,0,-
Jacob Wiley,BKN ,23,2,1,100%,0,1,0,0,100%,0,1,0,0.00%,0,0,-
Nick Collison,OKC ,37,3,1,100%,0,1,0,0,100%,0,1,0,0.00%,0,0,-
RJ Hunter,HOU ,24,1,1,100%,0,1,0,0,0.00%,0,0,-,100%,0,1,0
