name,team,age,gp,g,fgfreq,fgm,fga,fgp,efgp,2fgfreq,2fgm,2fga,2fgp,3pfreq,3pm,3pa,3pp
DeMar DeRozan,TOR ,28,80,80,100%,208,440,47.3,51.8,75.50%,168,332,50.6,24.50%,40,108,37
Damian Lillard,POR ,27,73,73,100%,187,422,44.3,52.4,57.10%,119,241,49.4,42.90%,68,181,37.6
Bradley Beal,WAS ,24,81,81,100%,215,415,51.8,60.7,61.70%,141,256,55.1,38.30%,74,159,46.5
Andrew Wiggins,MIN ,23,82,82,100%,185,415,44.6,48.8,72.50%,150,301,49.8,27.50%,35,114,30.7
Russell Westbrook,OKC ,29,78,78,100%,191,413,46.2,49,78.20%,168,323,52,21.80%,23,90,25.6
LeBron James,CLE ,33,81,79,100%,201,392,51.3,58.4,65.10%,145,255,56.9,34.90%,56,137,40.9
Victor Oladipo,IND ,26,74,74,100%,191,375,50.9,57.9,62.10%,139,233,59.7,37.90%,52,142,36.6
CJ McCollum,POR ,26,81,81,100%,182,374,48.7,55.9,66.60%,128,249,51.4,33.40%,54,125,43.2
James Harden,HOU ,28,72,71,100%,178,373,47.7,57.1,46.10%,108,172,62.8,53.90%,70,201,34.8
Paul George,OKC ,28,78,78,100%,151,371,40.7,48.2,53.90%,95,200,47.5,46.10%,56,171,32.7
Kemba Walker,CHA ,28,80,80,100%,143,361,39.6,47.2,54.80%,88,198,44.4,45.20%,55,163,33.7
Kevin Durant,GSW ,29,67,67,100%,175,360,48.6,56.4,58.90%,119,212,56.1,41.10%,56,148,37.8
Anthony Davis,NOP ,25,72,70,100%,185,354,52.3,55.4,83.30%,163,295,55.3,16.70%,22,59,37.3
Harrison Barnes,DAL ,25,77,77,100%,164,354,46.3,51.7,70.10%,126,248,50.8,29.90%,38,106,35.8
Tobias Harris,LAC ,25,80,80,100%,165,351,47,55.3,55.80%,107,196,54.6,44.20%,58,155,37.4
Jrue Holiday,NOP ,27,80,80,100%,172,347,49.6,54.5,65.10%,138,226,61.1,34.90%,34,121,28.1
LaMarcus Aldridge,SAS ,32,73,72,100%,182,345,52.8,53.2,93.30%,179,322,55.6,6.70%,3,23,13
Giannis Antetokounmpo,MIL ,23,73,72,100%,200,344,58.1,59.3,90.40%,192,311,61.7,9.60%,8,33,24.2
Donovan Mitchell,UTA ,21,79,74,100%,163,333,48.9,56.8,59.20%,111,197,56.3,40.80%,52,136,38.2
Khris Middleton,MIL ,26,81,80,100%,155,323,48,54.3,67.80%,114,219,52.1,32.20%,41,104,39.4
Carmelo Anthony,OKC ,33,75,75,100%,131,319,41.1,50.3,50.50%,72,161,44.7,49.50%,59,158,37.3
Lou Williams,LAC ,31,79,78,100%,134,290,46.2,54.1,58.30%,88,169,52.1,41.70%,46,121,38
Goran Dragic,MIA ,32,74,73,100%,124,288,43.1,47.9,69.40%,96,200,48,30.60%,28,88,31.8
Stephen Curry,GSW ,30,50,50,100%,162,287,56.4,72,40.10%,73,115,63.5,59.90%,89,172,51.7
Dennis Schroder,ATL ,24,66,65,100%,130,284,45.8,50.9,69.40%,101,197,51.3,30.60%,29,87,33.3
Jamal Murray,DEN ,21,80,79,100%,133,283,47,55.3,59.70%,86,169,50.9,40.30%,47,114,41.2
Kyle Lowry,TOR ,32,77,75,100%,113,280,40.4,52.5,35.40%,45,99,45.5,64.60%,68,181,37.6
TJ Warren,PHX ,24,64,63,100%,146,274,53.3,54.4,88.30%,140,242,57.9,11.70%,6,32,18.8
Devin Booker,PHX ,21,54,53,100%,122,271,45,52.6,61.60%,81,167,48.5,38.40%,41,104,39.4
Dwight Howard,CHA ,32,80,76,100%,163,269,60.6,60.6,100%,163,269,60.6,0.00%,0,0,-
Kyrie Irving,BOS ,26,55,55,100%,132,268,49.3,58.2,63.40%,84,170,49.4,36.60%,48,98,49
Marc Gasol,MEM ,33,73,71,100%,111,266,41.7,49.4,59.80%,70,159,44,40.20%,41,107,38.3
Nikola Jokic,DEN ,23,72,66,100%,145,265,54.7,62.8,62.60%,102,166,61.4,37.40%,43,99,43.4
Taurean Prince,ATL ,24,79,74,100%,107,264,40.5,49.8,49.60%,58,131,44.3,50.40%,49,133,36.8
Nikola Vucevic,ORL ,27,55,54,100%,130,263,49.4,54.2,71.50%,105,188,55.9,28.50%,25,75,33.3
Eric Bledsoe,MIL ,28,73,71,100%,129,260,49.6,57.3,59.20%,89,154,57.8,40.80%,40,106,37.7
Blake Griffin,DET ,29,57,57,100%,114,260,43.8,49,66.50%,87,173,50.3,33.50%,27,87,31
Karl-Anthony Towns,MIN ,22,81,77,100%,146,255,57.3,63.7,71.80%,113,183,61.7,28.20%,33,72,45.8
Zach Randolph,SAC ,36,59,58,100%,117,255,45.9,48.4,79.60%,104,203,51.2,20.40%,13,52,25
Aaron Gordon,ORL ,22,57,56,100%,118,251,47,54.6,59.40%,80,149,53.7,40.60%,38,102,37.3
Klay Thompson,GSW ,28,73,71,100%,134,249,53.8,65.7,50.20%,75,125,60,49.80%,59,124,47.6
Gary Harris,DEN ,23,66,64,100%,133,248,53.6,61.7,58.50%,93,145,64.1,41.50%,40,103,38.8
Jusuf Nurkic,POR ,23,79,75,100%,138,244,56.6,56.6,100%,138,244,56.6,0.00%,0,0,-
Otto Porter Jr.,WAS ,24,75,75,100%,128,244,52.5,61.7,60.70%,83,148,56.1,39.30%,45,96,46.9
Brook Lopez,LAL ,30,72,70,100%,112,244,45.9,53.5,55.70%,75,136,55.1,44.30%,37,108,34.3
Andre Drummond,DET ,24,78,77,100%,132,242,54.5,54.5,97.50%,132,236,55.9,2.50%,0,6,0
Kentavious Caldwell-Pope,LAL ,25,70,65,100%,97,238,40.8,50.4,47.50%,51,113,45.1,52.50%,46,125,36.8
Joel Embiid,PHI ,24,61,60,100%,130,232,56,59.3,78.40%,115,182,63.2,21.60%,15,50,30
Jeff Teague,MIN ,29,70,68,100%,117,229,51.1,56.6,75.10%,92,172,53.5,24.90%,25,57,43.9
Justin Holiday,CHI ,29,69,67,100%,85,229,37.1,47.6,42.80%,37,98,37.8,57.20%,48,131,36.6
Ben Simmons,PHI ,21,80,78,100%,132,228,57.9,57.9,98.70%,132,225,58.7,1.30%,0,3,0
Dennis Smith Jr.,DAL ,20,69,66,100%,105,228,46.1,51.3,67.50%,81,154,52.6,32.50%,24,74,32.4
Tim Hardaway Jr.,NYK ,26,57,57,100%,103,228,45.2,54.2,49.60%,62,113,54.9,50.40%,41,115,35.7
Serge Ibaka,TOR ,28,75,72,100%,110,227,48.5,56.6,56.80%,73,129,56.6,43.20%,37,98,37.8
Allen Crabbe,BKN ,26,73,72,100%,98,227,43.2,56.8,34.80%,36,79,45.6,65.20%,62,148,41.9
Lauri Markkanen,CHI ,21,67,66,100%,110,226,48.7,56.4,57.50%,75,130,57.7,42.50%,35,96,36.5
Robert Covington,PHI ,27,79,72,100%,96,222,43.2,55,32.90%,44,73,60.3,67.10%,52,149,34.9
Bojan Bogdanovic,IND ,29,79,74,100%,113,221,51.1,63.1,45.20%,60,100,60,54.80%,53,121,43.8
Austin Rivers,LAC ,25,60,59,100%,95,221,43,52,52.50%,55,116,47.4,47.50%,40,105,38.1
Wesley Matthews,DAL ,31,63,61,100%,94,220,42.7,56.8,35.50%,32,78,41,64.50%,62,142,43.7
E'Twaun Moore,NOP ,29,81,77,100%,100,218,45.9,52.3,61.90%,72,135,53.3,38.10%,28,83,33.7
Jaylen Brown,BOS ,21,67,63,100%,101,217,46.5,54.1,57.60%,68,125,54.4,42.40%,33,92,35.9
Brandon Ingram,LAL ,20,58,56,100%,109,216,50.5,53.2,84.70%,97,183,53,15.30%,12,33,36.4
Dario Saric,PHI ,24,76,73,100%,107,213,50.2,61.5,50.70%,59,108,54.6,49.30%,48,105,45.7
Al Horford,BOS ,31,69,66,100%,107,213,50.2,56.8,70.40%,79,150,52.7,29.60%,28,63,44.4
Eric Gordon,HOU ,29,68,65,100%,99,213,46.5,59.4,29.60%,44,63,69.8,70.40%,55,150,36.7
DeMarre Carroll,BKN ,31,71,69,100%,93,211,44.1,54.7,45.50%,48,96,50,54.50%,45,115,39.1
Evan Fournier,ORL ,25,57,57,100%,104,210,49.5,59,52.90%,64,111,57.7,47.10%,40,99,40.4
Enes Kanter,NYK ,26,70,67,100%,136,208,65.4,65.4,100%,136,208,65.4,0.00%,0,0,-
Jimmy Butler,MIN ,28,59,58,100%,113,208,54.3,59.1,77.90%,93,162,57.4,22.10%,20,46,43.5
Ricky Rubio,UTA ,27,76,70,100%,90,208,43.3,47.8,64.40%,71,134,53,35.60%,19,74,25.7
Nicolas Batum,CHA ,29,63,60,100%,91,207,44,52.9,58.50%,54,121,44.6,41.50%,37,86,43
Kyle Kuzma,LAL ,22,73,65,100%,90,207,43.5,51.4,52.20%,57,108,52.8,47.80%,33,99,33.3
Thaddeus Young,IND ,29,80,77,100%,108,206,52.4,55.1,79.10%,97,163,59.5,20.90%,11,43,25.6
Josh Richardson,MIA ,24,80,74,100%,88,206,42.7,49,62.10%,62,128,48.4,37.90%,26,78,33.3
JJ Redick,PHI ,33,69,65,100%,94,205,45.9,56.8,48.30%,49,99,49.5,51.70%,45,106,42.5
Courtney Lee,NYK ,32,74,68,100%,93,203,45.8,53.4,65.00%,62,132,47,35.00%,31,71,43.7
Chris Paul,HOU ,33,58,56,100%,86,201,42.8,54,44.30%,41,89,46.1,55.70%,45,112,40.2
Kevin Love,CLE ,29,56,54,100%,107,200,53.5,63.8,51.50%,66,103,64.1,48.50%,41,97,42.3
Will Barton,DEN ,27,80,74,100%,97,200,48.5,58.8,49.50%,56,99,56.6,50.50%,41,101,40.6
Jonas Valanciunas,TOR ,26,76,67,100%,120,198,60.6,62.1,89.90%,114,178,64,10.10%,6,20,30
Jonathon Simmons,ORL ,28,68,60,100%,114,198,57.6,64.1,70.70%,88,140,62.9,29.30%,26,58,44.8
Markieff Morris,WAS ,28,71,69,100%,107,198,54,60.9,68.20%,80,135,59.3,31.80%,27,63,42.9
Spencer Dinwiddie,BKN ,25,78,69,100%,91,198,46,57.1,46.50%,47,92,51.1,53.50%,44,106,41.5
Bogdan Bogdanovic,SAC ,25,78,66,100%,85,198,42.9,51.5,54.50%,51,108,47.2,45.50%,34,90,37.8
Ish Smith,DET ,29,82,76,100%,98,197,49.7,50.8,87.80%,94,173,54.3,12.20%,4,24,16.7
Josh Jackson,PHX ,21,74,63,100%,82,197,41.6,45.4,74.60%,67,147,45.6,25.40%,15,50,30
Myles Turner,IND ,22,64,58,100%,92,196,46.9,50.3,75.50%,79,148,53.4,24.50%,13,48,27.1
Taj Gibson,MIN ,32,81,74,100%,108,194,55.7,55.9,95.40%,107,185,57.8,4.60%,1,9,11.1
Willie Cauley-Stein,SAC ,24,72,67,100%,96,194,49.5,49.7,98.50%,95,191,49.7,1.50%,1,3,33.3
Wilson Chandler,DEN ,31,73,67,100%,94,193,48.7,56.5,56.50%,64,109,58.7,43.50%,30,84,35.7
Kristaps Porzingis,NYK ,22,46,45,100%,87,193,45.1,51.3,68.40%,63,132,47.7,31.60%,24,61,39.3
Darren Collison,IND ,30,68,66,100%,111,192,57.8,66.9,64.10%,76,123,61.8,35.90%,35,69,50.7
Rodney Hood,CLE ,25,58,57,100%,88,187,47.1,57.2,53.50%,50,100,50,46.50%,38,87,43.7
Dillon Brooks,MEM ,22,82,69,100%,96,186,51.6,59.4,64.50%,67,120,55.8,35.50%,29,66,43.9
DeMarcus Cousins,NOP ,27,48,47,100%,91,186,48.9,57,53.80%,61,100,61,46.20%,30,86,34.9
John Wall,WAS ,27,41,41,100%,85,186,45.7,51.1,75.30%,65,140,46.4,24.70%,20,46,43.5
Joe Ingles,UTA ,30,82,73,100%,93,185,50.3,63.8,40.00%,43,74,58.1,60.00%,50,111,45
Tyler Johnson,MIA ,26,70,63,100%,89,184,48.4,58.4,55.40%,52,102,51,44.60%,37,82,45.1
Marvin Williams,CHA ,31,78,72,100%,87,184,47.3,59.2,43.50%,43,80,53.8,56.50%,44,104,42.3
Marco Belinelli,PHI ,32,77,74,100%,83,182,45.6,57.7,39.00%,39,71,54.9,61.00%,44,111,39.6
Elfrid Payton,PHX ,24,62,57,100%,99,181,54.7,57.2,84.50%,90,153,58.8,15.50%,9,28,32.1
Patty Mills,SAS ,29,80,72,100%,70,181,38.7,49.7,42.50%,30,77,39,57.50%,40,104,38.5
Jayson Tatum,BOS ,20,76,71,100%,87,180,48.3,55.6,62.80%,61,113,54,37.20%,26,67,38.8
Dirk Nowitzki,DAL ,39,77,68,100%,87,179,48.6,61.2,45.30%,42,81,51.9,54.70%,45,98,45.9
Robin Lopez,CHI ,30,57,57,100%,95,178,53.4,53.7,98.30%,94,175,53.7,1.70%,1,3,33.3
De'Aaron Fox,SAC ,20,69,63,100%,75,178,42.1,46.1,79.20%,61,141,43.3,20.80%,14,37,37.8
Jae Crowder,UTA ,27,79,74,100%,74,178,41.6,50.3,50.60%,43,90,47.8,49.40%,31,88,35.2
Marcin Gortat,WAS ,34,82,77,100%,115,177,65,65,100%,115,177,65,0.00%,0,0,-
Kris Dunn,CHI ,24,52,49,100%,75,176,42.6,46.6,75.60%,61,133,45.9,24.40%,14,43,32.6
Michael Kidd-Gilchrist,CHA ,24,71,69,100%,102,175,58.3,58.3,99.40%,102,174,58.6,0.60%,0,1,0
Derrick Favors,UTA ,26,76,67,100%,99,174,56.9,58.3,89.10%,94,155,60.6,10.90%,5,19,26.3
George Hill,CLE ,32,65,54,100%,88,173,50.9,60.4,56.60%,55,98,56.1,43.40%,33,75,44
Al-Farouq Aminu,POR ,27,69,64,100%,69,173,39.9,50.3,42.80%,33,74,44.6,57.20%,36,99,36.4
JR Smith,CLE ,32,78,69,100%,61,172,35.5,47.4,32.00%,20,55,36.4,68.00%,41,117,35
Michael Beasley,NYK ,29,65,55,100%,84,168,50,51.8,87.50%,78,147,53.1,12.50%,6,21,28.6
Tyreke Evans,MEM ,28,52,49,100%,77,168,45.8,54.8,60.10%,47,101,46.5,39.90%,30,67,44.8
Trevor Ariza,HOU ,32,66,62,100%,65,168,38.7,52.1,24.40%,20,41,48.8,75.60%,45,127,35.4
Avery Bradley,LAC ,27,46,45,100%,71,166,42.8,48.2,64.50%,53,107,49.5,35.50%,18,59,30.5
Stanley Johnson,DET ,21,65,55,100%,70,166,42.2,48.8,55.40%,48,92,52.2,44.60%,22,74,29.7
Rondae Hollis-Jefferson,BKN ,23,63,57,100%,91,163,55.8,57.4,89.60%,86,146,58.9,10.40%,5,17,29.4
Denzel Valentine,CHI ,24,77,66,100%,78,161,48.4,61.2,39.80%,37,64,57.8,60.20%,41,97,42.3
Draymond Green,GSW ,28,67,58,100%,83,159,52.2,58.8,60.40%,62,96,64.6,39.60%,21,63,33.3
James Johnson,MIA ,31,70,60,100%,79,158,50,55.1,63.90%,63,101,62.4,36.10%,16,57,28.1
Julius Randle,LAL ,23,76,62,100%,103,157,65.6,65.9,97.50%,102,153,66.7,2.50%,1,4,25
Jeremy Lamb,CHA ,25,78,61,100%,66,157,42,49,65.00%,44,102,43.1,35.00%,22,55,40
Steven Adams,OKC ,24,75,65,100%,107,156,68.6,68.6,99.40%,107,155,69,0.60%,0,1,0
Pau Gasol,SAS ,37,75,59,100%,80,155,51.6,55.5,79.40%,68,123,55.3,20.60%,12,32,37.5
Kent Bazemore,ATL ,28,63,59,100%,74,155,47.7,56.8,54.20%,46,84,54.8,45.80%,28,71,39.4
Hassan Whiteside,MIA ,28,54,50,100%,96,153,62.7,62.7,100%,96,153,62.7,0.00%,0,0,-
Lonzo Ball,LAL ,20,51,45,100%,66,153,43.1,52.3,45.10%,38,69,55.1,54.90%,28,84,33.3
D'Angelo Russell,BKN ,22,47,46,100%,70,151,46.4,51,66.20%,56,100,56,33.80%,14,51,27.5
Clint Capela,HOU ,24,74,65,100%,116,150,77.3,77.3,100%,116,150,77.3,0.00%,0,0,-
Buddy Hield,SAC ,24,69,58,100%,66,148,44.6,55.1,54.70%,35,81,43.2,45.30%,31,67,46.3
Terry Rozier,BOS ,24,75,61,100%,57,147,38.8,49,46.30%,27,68,39.7,53.70%,30,79,38
DeAndre Jordan,LAC ,29,76,64,100%,99,146,67.8,67.8,100%,99,146,67.8,0.00%,0,0,-
Nikola Mirotic,NOP ,27,54,50,100%,67,145,46.2,55.5,51.00%,40,74,54.1,49.00%,27,71,38
Ersan Ilyasova,PHI ,31,68,57,100%,58,145,40,45.2,57.20%,43,83,51.8,42.80%,15,62,24.2
Dejounte Murray,SAS ,21,71,61,100%,82,144,56.9,57.6,96.50%,80,139,57.6,3.50%,2,5,40
Yogi Ferrell,DAL ,25,75,63,100%,58,142,40.8,49.3,53.50%,34,76,44.7,46.50%,24,66,36.4
Danny Green,SAS ,30,66,58,100%,57,140,40.7,54.3,38.60%,19,54,35.2,61.40%,38,86,44.2
John Collins,ATL ,20,72,64,100%,86,139,61.9,63.7,90.60%,81,126,64.3,9.40%,5,13,38.5
Jordan Clarkson,CLE ,25,78,70,100%,68,139,48.9,57.2,59.00%,45,82,54.9,41.00%,23,57,40.4
Marcus Morris,BOS ,28,52,49,100%,65,139,46.8,54,60.40%,45,84,53.6,39.60%,20,55,36.4
Dewayne Dedmon,ATL ,28,60,56,100%,67,138,48.6,53.6,66.70%,53,92,57.6,33.30%,14,46,30.4
Troy Daniels,PHX ,26,69,52,100%,61,137,44.5,61.7,18.20%,14,25,56,81.80%,47,112,42
Bobby Portis,CHI ,23,73,55,100%,60,136,44.1,48.9,68.40%,47,93,50.5,31.60%,13,43,30.2
Marcus Smart,BOS ,24,51,47,100%,55,136,40.4,47.4,51.50%,36,70,51.4,48.50%,19,66,28.8
Reggie Bullock,DET ,27,54,54,100%,72,135,53.3,67.8,45.20%,33,61,54.1,54.80%,39,74,52.7
Tyler Ulis,PHX ,22,68,55,100%,55,135,40.7,43,77.80%,49,105,46.7,22.20%,6,30,20
Evan Turner,POR ,29,79,62,100%,59,132,44.7,50.4,72.70%,44,96,45.8,27.30%,15,36,41.7
Joe Harris,BKN ,26,77,63,100%,69,130,53.1,65.8,40.00%,36,52,69.2,60.00%,33,78,42.3
Rudy Gay,SAS ,31,56,52,100%,66,130,50.8,54.2,77.70%,57,101,56.4,22.30%,9,29,31
Caris LeVert,BKN ,23,69,59,100%,60,130,46.2,51.9,63.10%,45,82,54.9,36.90%,15,48,31.3
Garrett Temple,SAC ,32,62,50,100%,57,129,44.2,52.3,55.80%,36,72,50,44.20%,21,57,36.8
John Henson,MIL ,27,72,62,100%,89,127,70.1,70.1,100%,89,127,70.1,0.00%,0,0,-
J.J. Barea,DAL ,33,68,57,100%,50,127,39.4,48,44.90%,28,57,49.1,55.10%,22,70,31.4
Marquese Chriss,PHX ,20,70,57,100%,59,126,46.8,52.4,54.80%,45,69,65.2,45.20%,14,57,24.6
Bryn Forbes,SAS ,24,64,51,100%,51,123,41.5,50.8,56.10%,28,69,40.6,43.90%,23,54,42.6
Aron Baynes,BOS ,31,75,56,100%,62,122,50.8,50.8,93.40%,62,114,54.4,6.60%,0,8,0
Mario Hezonja,ORL ,23,59,49,100%,55,121,45.5,55,52.10%,32,63,50.8,47.90%,23,58,39.7
Andrew Harrison,MEM ,23,52,47,100%,52,121,43,47.5,69.40%,41,84,48.8,30.60%,11,37,29.7
Manu Ginobili,SAS ,40,59,52,100%,53,120,44.2,52.9,55.00%,32,66,48.5,45.00%,21,54,38.9
Justin Jackson,SAC ,23,56,51,100%,53,118,44.9,52.5,46.60%,35,55,63.6,53.40%,18,63,28.6
CJ Miles,TOR ,31,64,56,100%,43,117,36.8,51.3,23.10%,9,27,33.3,76.90%,34,90,37.8
Rajon Rondo,NOP ,32,61,54,100%,54,116,46.6,50.9,65.50%,44,76,57.9,34.50%,10,40,25
Dragan Bender,PHX ,20,78,57,100%,47,116,40.5,53.9,25.90%,16,30,53.3,74.10%,31,86,36
Jamal Crawford,MIN ,38,74,59,100%,46,116,39.7,45.7,62.90%,32,73,43.8,37.10%,14,43,32.6
Kyle Anderson,SAS ,24,73,53,100%,66,115,57.4,60.4,88.70%,59,102,57.8,11.30%,7,13,53.8
Dwyane Wade,MIA ,36,65,55,100%,46,115,40,43.5,74.80%,38,86,44.2,25.20%,8,29,27.6
Paul Millsap,DEN ,33,36,35,100%,57,114,50,53.5,76.30%,49,87,56.3,23.70%,8,27,29.6
Domantas Sabonis,IND ,22,74,57,100%,58,113,51.3,51.8,92.00%,57,104,54.8,8.00%,1,9,11.1
Wayne Ellington,MIA ,30,70,55,100%,42,113,37.2,50.9,15.00%,11,17,64.7,85.00%,31,96,32.3
D.J. Augustin,ORL ,30,68,45,100%,61,112,54.5,68.8,39.30%,29,44,65.9,60.70%,32,68,47.1
Jarell Martin,MEM ,24,68,53,100%,50,111,45,48.2,81.10%,43,90,47.8,18.90%,7,21,33.3
Reggie Jackson,DET ,28,45,42,100%,44,109,40.4,45,63.30%,34,69,49.3,36.70%,10,40,25
Kelly Oubre Jr.,WAS ,22,80,56,100%,41,109,37.6,48.6,37.60%,17,41,41.5,62.40%,24,68,35.3
Dion Waiters,MIA ,26,28,27,100%,39,109,35.8,41.7,52.30%,26,57,45.6,47.70%,13,52,25
Kelly Olynyk,MIA ,27,67,54,100%,58,108,53.7,64.8,48.10%,34,52,65.4,51.90%,24,56,42.9
PJ Tucker,HOU ,33,82,61,100%,45,107,42.1,54.7,27.10%,18,29,62.1,72.90%,27,78,34.6
JaMychal Green,MEM ,27,54,47,100%,56,106,52.8,60.8,68.90%,39,73,53.4,31.10%,17,33,51.5
Jeff Green,CLE ,31,69,51,100%,55,106,51.9,56.1,71.70%,46,76,60.5,28.30%,9,30,30
Jarrett Jack,NYK ,34,59,49,100%,40,103,38.8,42.2,81.60%,33,84,39.3,18.40%,7,19,36.8
T.J. McConnell,PHI ,26,71,52,100%,56,102,54.9,59.8,83.30%,46,85,54.1,16.70%,10,17,58.8
Justise Winslow,MIA ,22,66,53,100%,49,102,48,52,75.50%,41,77,53.2,24.50%,8,25,32
Ryan Anderson,HOU ,30,62,47,100%,48,102,47.1,61.3,27.50%,19,28,67.9,72.50%,29,74,39.2
Jerian Grant,CHI ,25,68,50,100%,47,102,46.1,51,67.60%,37,69,53.6,32.40%,10,33,30.3
Rudy Gobert,UTA ,25,55,47,100%,70,100,70,70,100%,70,100,70,0.00%,0,0,-
Mario Chalmers,MEM ,32,64,47,100%,32,100,32,35,59.00%,26,59,44.1,41.00%,6,41,14.6
OG Anunoby,TOR ,20,69,50,100%,47,99,47.5,57.1,44.40%,28,44,63.6,55.60%,19,55,34.5
Cory Joseph,IND ,26,81,58,100%,44,99,44.4,49,75.80%,35,75,46.7,24.20%,9,24,37.5
Joe Johnson,HOU ,36,55,43,100%,40,99,40.4,47.5,59.60%,26,59,44.1,40.40%,14,40,35
Larry Nance Jr.,CLE ,25,60,45,100%,65,98,66.3,66.8,95.90%,64,94,68.1,4.10%,1,4,25
Frank Kaminsky,CHA ,25,74,55,100%,42,98,42.9,50.5,53.10%,27,52,51.9,46.90%,15,46,32.6
Anthony Tolliver,DET ,32,68,53,100%,49,97,50.5,71.6,17.50%,8,17,47.1,82.50%,41,80,51.3
Devin Harris,DEN ,35,66,48,100%,37,97,38.1,47.9,39.20%,18,38,47.4,60.80%,19,59,32.2
Wesley Johnson,LAC ,30,65,44,100%,35,97,36.1,43.8,52.60%,20,51,39.2,47.40%,15,46,32.6
Frank Ntilikina,NYK ,19,69,54,100%,29,96,30.2,34.4,64.60%,21,62,33.9,35.40%,8,34,23.5
Mason Plumlee,DEN ,28,70,51,100%,71,95,74.7,74.7,100%,71,95,74.7,0.00%,0,0,-
Jarrett Allen,BKN ,20,64,47,100%,57,94,60.6,61.2,96.80%,56,91,61.5,3.20%,1,3,33.3
Darius Miller,NOP ,28,76,56,100%,36,94,38.3,50.5,26.60%,13,25,52,73.40%,23,69,33.3
Lance Stephenson,IND ,27,78,45,100%,35,94,37.2,42,53.20%,26,50,52,46.80%,9,44,20.5
Tony Parker,SAS ,36,55,41,100%,34,94,36.2,38.3,80.90%,30,76,39.5,19.10%,4,18,22.2
Zaza Pachulia,GSW ,34,64,51,100%,62,93,66.7,66.7,98.90%,62,92,67.4,1.10%,0,1,0
Malcolm Brogdon,MIL ,25,45,36,100%,55,93,59.1,68.8,62.40%,37,58,63.8,37.60%,18,35,51.4
Isaiah Thomas,LAL ,29,30,29,100%,45,92,48.9,57.1,55.40%,30,51,58.8,44.60%,15,41,36.6
Dante Cunningham,BKN ,31,65,43,100%,38,92,41.3,50,44.60%,22,41,53.7,55.40%,16,51,31.4
Doug McDermott,DAL ,26,65,45,100%,39,91,42.9,52.2,53.80%,22,49,44.9,46.20%,17,42,40.5
Trey Lyles,DEN ,22,52,39,100%,49,90,54.4,64.4,56.70%,31,51,60.8,43.30%,18,39,46.2
Nick Young,GSW ,32,68,46,100%,38,90,42.2,58.9,23.30%,8,21,38.1,76.70%,30,69,43.5
Tyler Zeller,MIL ,28,56,44,100%,59,89,66.3,68,91.00%,56,81,69.1,9.00%,3,8,37.5
Skal Labissiere,SAC ,22,49,43,100%,46,89,51.7,52.2,91.00%,45,81,55.6,9.00%,1,8,12.5
Tony Snell,MIL ,26,72,49,100%,43,89,48.3,64.6,27.00%,14,24,58.3,73.00%,29,65,44.6
Trey Burke,NYK ,25,24,24,100%,42,88,47.7,51.7,75.00%,35,66,53,25.00%,7,22,31.8
Emmanuel Mudiay,NYK ,22,50,42,100%,35,88,39.8,42,78.40%,31,69,44.9,21.60%,4,19,21.1
Quincy Acy,BKN ,27,60,46,100%,33,88,37.5,52.3,22.70%,7,20,35,77.30%,26,68,38.2
James Ennis III,DET ,27,64,44,100%,47,85,55.3,62.4,57.60%,35,49,71.4,42.40%,12,36,33.3
Tomas Satoransky,WAS ,26,66,45,100%,44,85,51.8,58.2,70.60%,33,60,55,29.40%,11,25,44
Zach LaVine,CHI ,23,24,24,100%,36,85,42.4,50.6,58.80%,22,50,44,41.20%,14,35,40
Alex Len,PHX ,24,65,41,100%,53,84,63.1,63.1,98.80%,53,83,63.9,1.20%,0,1,0
Maxi Kleber,DAL ,26,56,43,100%,38,83,45.8,50.6,53.00%,30,44,68.2,47.00%,8,39,20.5
Gerald Green,HOU ,32,38,30,100%,32,83,38.6,51.2,25.30%,11,21,52.4,74.70%,21,62,33.9
Luke Kennard,DET ,21,58,47,100%,30,83,36.1,45.2,56.60%,15,47,31.9,43.40%,15,36,41.7
Greg Monroe,BOS ,27,45,39,100%,56,82,68.3,68.3,100%,56,82,68.3,0.00%,0,0,-
Pascal Siakam,TOR ,24,72,46,100%,46,82,56.1,62.2,64.60%,36,53,67.9,35.40%,10,29,34.5
Lance Thomas,NYK ,30,63,42,100%,36,81,44.4,53.7,59.30%,21,48,43.8,40.70%,15,33,45.5
Ben McLemore,MEM ,25,47,37,100%,23,81,28.4,33.3,53.10%,15,43,34.9,46.90%,8,38,21.1
Milos Teodosic,LAC ,31,42,35,100%,29,80,36.3,46.3,38.80%,13,31,41.9,61.30%,16,49,32.7
David Nwaba,CHI ,25,61,37,100%,41,79,51.9,56.3,82.30%,34,65,52.3,17.70%,7,14,50
Davis Bertans,SAS ,25,41,32,100%,36,79,45.6,58.2,34.20%,16,27,59.3,65.80%,20,52,38.5
Dwight Powell,DAL ,26,65,40,100%,49,78,62.8,68.6,73.10%,40,57,70.2,26.90%,9,21,42.9
Josh Hart,LAL ,23,53,34,100%,47,78,60.3,71.8,50.00%,29,39,74.4,50.00%,18,39,46.2
Kosta Koufos,SAC ,29,61,42,100%,51,77,66.2,66.2,100%,51,77,66.2,0.00%,0,0,-
Jonas Jerebko,UTA ,31,60,37,100%,42,77,54.5,63.6,51.90%,28,40,70,48.10%,14,37,37.8
Ian Clark,NOP ,27,56,39,100%,37,74,50,56.8,58.10%,27,43,62.8,41.90%,10,31,32.3
Mike Scott,WAS ,29,61,40,100%,34,74,45.9,51.4,55.40%,26,41,63.4,44.60%,8,33,24.2
Kyle O'Quinn,NYK ,28,67,46,100%,55,73,75.3,76,93.20%,54,68,79.4,6.80%,1,5,20
Luc Mbah a Moute,HOU ,31,58,40,100%,34,73,46.6,53.4,49.30%,24,36,66.7,50.70%,10,37,27
Raymond Felton,OKC ,33,71,45,100%,30,73,41.1,50.7,42.50%,16,31,51.6,57.50%,14,42,33.3
Alec Burks,UTA ,26,52,34,100%,30,73,41.1,45.9,69.90%,23,51,45.1,30.10%,7,22,31.8
Shabazz Napier,POR ,26,57,37,100%,29,73,39.7,48.6,46.60%,16,34,47.1,53.40%,13,39,33.3
Mike Muscala,ATL ,26,42,31,100%,40,72,55.6,65.3,54.20%,26,39,66.7,45.80%,14,33,42.4
Corey Brewer,OKC ,32,45,31,100%,39,72,54.2,59.7,59.70%,31,43,72.1,40.30%,8,29,27.6
Quinn Cook,GSW ,25,24,24,100%,37,71,52.1,63.4,54.90%,21,39,53.8,45.10%,16,32,50
Pat Connaughton,POR ,25,76,48,100%,36,71,50.7,63.4,46.50%,18,33,54.5,53.50%,18,38,47.4
Tyrone Wallace,LAC ,23,29,26,100%,33,71,46.5,49.3,74.60%,29,53,54.7,25.40%,4,18,22.2
Jabari Parker,MIL ,23,31,27,100%,41,70,58.6,61.4,78.60%,37,55,67.3,21.40%,4,15,26.7
Maurice Harkless,POR ,25,46,36,100%,29,70,41.4,47.9,58.60%,20,41,48.8,41.40%,9,29,31
Thon Maker,MIL ,21,63,37,100%,28,69,40.6,46.4,60.90%,20,42,47.6,39.10%,8,27,29.6
Gorgui Dieng,MIN ,28,77,44,100%,34,68,50,55.1,79.40%,27,54,50,20.60%,7,14,50
Montrezl Harrell,LAC ,24,66,34,100%,44,67,65.7,65.7,98.50%,44,66,66.7,1.50%,0,1,0
Bam Adebayo,MIA ,20,57,38,100%,38,67,56.7,56.7,94.00%,38,63,60.3,6.00%,0,4,0
JaVale McGee,GSW ,30,48,30,100%,51,66,77.3,77.3,100%,51,66,77.3,0.00%,0,0,-
Andre Iguodala,GSW ,34,63,38,100%,31,66,47,56.8,56.10%,18,37,48.6,43.90%,13,29,44.8
Kyle Korver,CLE ,37,64,38,100%,30,65,46.2,62.3,23.10%,9,15,60,76.90%,21,50,42
Mike James,NOP ,27,26,24,100%,24,65,36.9,41.5,72.30%,18,47,38.3,27.70%,6,18,33.3
Amir Johnson,PHI ,31,70,41,100%,41,64,64.1,65.6,89.10%,39,57,68.4,10.90%,2,7,28.6
Tyler Dorsey,ATL ,22,33,28,100%,27,64,42.2,52.3,40.60%,14,26,53.8,59.40%,13,38,34.2
Nemanja Bjelica,MIN ,30,55,28,100%,28,63,44.4,54,46.00%,16,29,55.2,54.00%,12,34,35.3
Danilo Gallinari,LAC ,29,20,19,100%,27,63,42.9,53.2,49.20%,14,31,45.2,50.80%,13,32,40.6
Trevor Booker,IND ,30,59,31,100%,32,62,51.6,53.2,88.70%,30,55,54.5,11.30%,2,7,28.6
Fred VanVleet,TOR ,24,55,33,100%,24,62,38.7,48.4,43.50%,12,27,44.4,56.50%,12,35,34.3
Tyus Jones,MIN ,22,66,33,100%,31,61,50.8,60.7,50.80%,19,31,61.3,49.20%,12,30,40
Marreese Speights,ORL ,30,37,29,100%,29,61,47.5,62.3,34.40%,11,21,52.4,65.60%,18,40,45
Isaiah Taylor,ATL ,23,52,37,100%,28,61,45.9,47.5,80.30%,26,49,53.1,19.70%,2,12,16.7
Norman Powell,TOR ,25,40,23,100%,23,60,38.3,45,48.30%,15,29,51.7,51.70%,8,31,25.8
Malcolm Delaney,ATL ,29,47,35,100%,23,60,38.3,45.8,50.00%,14,30,46.7,50.00%,9,30,30
Jakob Poeltl,TOR ,22,66,41,100%,41,59,69.5,69.5,100%,41,59,69.5,0.00%,0,0,-
Bismack Biyombo,ORL ,25,69,37,100%,30,58,51.7,51.7,100%,30,58,51.7,0.00%,0,0,-
Royce O'Neale,UTA ,24,52,34,100%,24,55,43.6,49.1,56.40%,18,31,58.1,43.60%,6,24,25
Sindarius Thornwell,LAC ,23,56,31,100%,22,55,40,45.5,63.60%,16,35,45.7,36.40%,6,20,30
Jerami Grant,OKC ,24,79,40,100%,24,54,44.4,47.2,70.40%,21,38,55.3,29.60%,3,16,18.8
Tristan Thompson,CLE ,27,43,31,100%,31,53,58.5,58.5,100%,31,53,58.5,0.00%,0,0,-
Nene,HOU ,35,47,32,100%,34,52,65.4,65.4,98.10%,34,51,66.7,1.90%,0,1,0
Jose Calderon,CLE ,36,38,26,100%,27,52,51.9,67.3,38.50%,11,20,55,61.50%,16,32,50
Shelvin Mack,ORL ,28,58,28,100%,19,52,36.5,44.2,53.80%,11,28,39.3,46.20%,8,24,33.3
Deyonta Davis,MEM ,21,49,35,100%,33,51,64.7,64.7,100%,33,51,64.7,0.00%,0,0,-
Cedi Osman,CLE ,23,33,24,100%,29,51,56.9,71.6,47.10%,14,24,58.3,52.90%,15,27,55.6
Jawun Evans,LAC ,21,41,29,100%,15,51,29.4,32.4,70.60%,12,36,33.3,29.40%,3,15,20
Chandler Parsons,MEM ,29,30,24,100%,22,50,44,56,50.00%,10,25,40,50.00%,12,25,48
Ed Davis,POR ,28,74,38,100%,35,49,71.4,71.4,100%,35,49,71.4,0.00%,0,0,-
Richaun Holmes,PHI ,24,35,24,100%,31,49,63.3,64.3,91.80%,30,45,66.7,8.20%,1,4,25
Wayne Selden,MEM ,23,30,26,100%,25,49,51,63.3,49.00%,13,24,54.2,51.00%,12,25,48
Malik Monk,CHA ,20,35,27,100%,21,49,42.9,58.2,42.90%,6,21,28.6,57.10%,15,28,53.6
Jameer Nelson,DET ,36,41,30,100%,19,49,38.8,45.9,51.00%,12,25,48,49.00%,7,24,29.2
Patrick McCaw,GSW ,22,40,24,100%,17,49,34.7,38.8,55.10%,13,27,48.1,44.90%,4,22,18.2
Timothe Luwawu-Cabarrot,PHI ,23,36,27,100%,13,49,26.5,29.6,34.70%,10,17,58.8,65.30%,3,32,9.4
Jerryd Bayless,PHI ,29,36,24,100%,23,48,47.9,58.3,45.80%,13,22,59.1,54.20%,10,26,38.5
Frank Mason,SAC ,24,41,28,100%,20,48,41.7,44.8,75.00%,17,36,47.2,25.00%,3,12,25
Jordan Bell,GSW ,23,44,28,100%,36,47,76.6,76.6,97.90%,36,46,78.3,2.10%,0,1,0
Miles Plumlee,ATL ,29,48,30,100%,30,47,63.8,63.8,100%,30,47,63.8,0.00%,0,0,-
Vince Carter,SAC ,41,40,30,100%,25,47,53.2,67,38.30%,12,18,66.7,61.70%,13,29,44.8
Cameron Payne,CHI ,23,24,23,100%,21,47,44.7,57.4,48.90%,9,23,39.1,51.10%,12,24,50
Thabo Sefolosha,UTA ,34,37,27,100%,27,46,58.7,67.4,60.90%,19,28,67.9,39.10%,8,18,44.4
Noah Vonleh,CHI ,22,34,22,100%,23,46,50,51.1,76.10%,22,35,62.9,23.90%,1,11,9.1
Kevon Looney,GSW ,22,45,24,100%,29,45,64.4,64.4,95.60%,29,43,67.4,4.40%,0,2,0
Luke Babbitt,MIA ,28,24,18,100%,18,45,40,54.4,20.00%,5,9,55.6,80.00%,13,36,36.1
Sean Kilpatrick,CHI ,28,24,19,100%,17,45,37.8,44.4,51.10%,11,23,47.8,48.90%,6,22,27.3
Tyson Chandler,PHX ,35,46,26,100%,37,43,86,86,100%,37,43,86,0.00%,0,0,-
Treveon Graham,CHA ,24,46,24,100%,23,43,53.5,65.1,51.20%,13,22,59.1,48.80%,10,21,47.6
Delon Wright,TOR ,26,50,30,100%,23,43,53.5,61.6,55.80%,16,24,66.7,44.20%,7,19,36.8
Channing Frye,LAL ,35,35,23,100%,23,42,54.8,66.7,42.90%,13,18,72.2,57.10%,10,24,41.7
Kobi Simmons,MEM ,20,25,17,100%,22,42,52.4,57.1,73.80%,18,31,58.1,26.20%,4,11,36.4
Zach Collins,POR ,20,54,29,100%,20,42,47.6,57.1,57.10%,12,24,50,42.90%,8,18,44.4
Cristiano Felicio,CHI ,25,44,19,100%,26,40,65,65,100%,26,40,65,0.00%,0,0,-
Shaun Livingston,GSW ,32,38,23,100%,21,40,52.5,52.5,100%,21,40,52.5,0.00%,0,0,-
Justin Anderson,PHI ,24,26,21,100%,19,40,47.5,56.3,42.50%,12,17,70.6,57.50%,7,23,30.4
Dwayne Bacon,CHA ,22,26,20,100%,16,40,40,47.5,72.50%,10,29,34.5,27.50%,6,11,54.5
Andre Roberson,OKC ,26,37,24,100%,27,39,69.2,73.1,74.40%,24,29,82.8,25.60%,3,10,30
Ivan Rabb,MEM ,21,22,15,100%,21,39,53.8,53.8,100%,21,39,53.8,0.00%,0,0,-
C.J. Williams,LAC ,28,30,21,100%,17,39,43.6,51.3,61.50%,11,24,45.8,38.50%,6,15,40
Damion Lee,ATL ,25,14,13,100%,14,39,35.9,38.5,53.80%,12,21,57.1,46.20%,2,18,11.1
Joffrey Lauvergne,SAS ,26,31,18,100%,24,38,63.2,63.2,97.40%,24,37,64.9,2.60%,0,1,0
Omri Casspi,GSW ,29,32,24,100%,24,38,63.2,64.5,84.20%,23,32,71.9,15.80%,1,6,16.7
Terrence Ross,ORL ,27,23,19,100%,14,38,36.8,43.4,57.90%,9,22,40.9,42.10%,5,16,31.3
Patrick Patterson,OKC ,29,61,24,100%,12,38,31.6,36.8,42.10%,8,16,50,57.90%,4,22,18.2
Al Jefferson,IND ,33,27,24,100%,22,37,59.5,59.5,100%,22,37,59.5,0.00%,0,0,-
Tyler Ennis,LAL ,23,32,21,100%,19,37,51.4,54.1,75.70%,17,28,60.7,24.30%,2,9,22.2
Josh Huestis,OKC ,26,49,27,100%,16,37,43.2,58.1,27.00%,5,10,50,73.00%,11,27,40.7
Derrick Rose,MIN ,29,15,13,100%,16,36,44.4,47.2,77.80%,14,28,50,22.20%,2,8,25
Nik Stauskas,BKN ,24,26,18,100%,15,36,41.7,55.6,25.00%,5,9,55.6,75.00%,10,27,37
Isaiah Canaan,PHX ,27,17,16,100%,14,36,38.9,44.4,50.00%,10,18,55.6,50.00%,4,18,22.2
Patrick Beverley,LAC ,29,11,11,100%,14,36,38.9,51.4,33.30%,5,12,41.7,66.70%,9,24,37.5
Sterling Brown,MIL ,23,31,22,100%,12,36,33.3,41.7,38.90%,6,14,42.9,61.10%,6,22,27.3
Mike Conley,MEM ,30,12,12,100%,13,35,37.1,42.9,48.60%,9,17,52.9,51.40%,4,18,22.2
Wes Iwundu,ORL ,23,40,19,100%,13,35,37.1,38.6,74.30%,12,26,46.2,25.70%,1,9,11.1
Paul Zipser,CHI ,24,33,19,100%,10,35,28.6,34.3,45.70%,6,16,37.5,54.30%,4,19,21.1
Alex Abrines,OKC ,24,39,22,100%,15,34,44.1,60.3,14.70%,4,5,80,85.30%,11,29,37.9
Dwight Buycks,DET ,29,22,19,100%,14,34,41.2,47.1,73.50%,10,25,40,26.50%,4,9,44.4
Langston Galloway,DET ,26,37,23,100%,11,34,32.4,47.1,35.30%,1,12,8.3,64.70%,10,22,45.5
Dorian Finney-Smith,DAL ,25,19,15,100%,14,33,42.4,53,42.40%,7,14,50,57.60%,7,19,36.8
Jamil Wilson,LAC ,27,13,12,100%,20,32,62.5,85.9,21.90%,5,7,71.4,78.10%,15,25,60
Terrance Ferguson,OKC ,20,37,22,100%,14,32,43.8,54.7,28.10%,7,9,77.8,71.90%,7,23,30.4
Daniel Theis,BOS ,26,42,20,100%,16,31,51.6,54.8,77.40%,14,24,58.3,22.60%,2,7,28.6
Jared Dudley,PHX ,32,30,18,100%,14,31,45.2,56.5,35.50%,7,11,63.6,64.50%,7,20,35
DeAndre' Bembry,ATL ,23,22,18,100%,11,31,35.5,41.9,74.20%,7,23,30.4,25.80%,4,8,50
Emeka Okafor,NOP ,35,17,14,100%,20,30,66.7,66.7,100%,20,30,66.7,0.00%,0,0,-
Shabazz Muhammad,MIL ,25,10,10,100%,17,30,56.7,58.3,83.30%,16,25,64,16.70%,1,5,20
Sam Dekker,LAC ,24,46,21,100%,14,30,46.7,50,66.70%,12,20,60,33.30%,2,10,20
Myke Henry,MEM ,25,18,15,100%,11,30,36.7,43.3,53.30%,7,16,43.8,46.70%,4,14,28.6
Willie Reed,DET ,28,28,16,100%,22,29,75.9,75.9,100%,22,29,75.9,0.00%,0,0,-
Tim Frazier,WAS ,27,36,18,100%,16,28,57.1,60.7,78.60%,14,22,63.6,21.40%,2,6,33.3
Jodie Meeks,WAS ,30,41,19,100%,13,28,46.4,64.3,25.00%,3,7,42.9,75.00%,10,21,47.6
Matthew Dellavedova,MIL ,27,33,18,100%,9,28,32.1,41.1,46.40%,4,13,30.8,53.60%,5,15,33.3
Torrey Craig,DEN ,27,32,18,100%,13,27,48.1,57.4,40.70%,8,11,72.7,59.30%,5,16,31.3
Markelle Fultz,PHI ,20,14,12,100%,11,27,40.7,40.7,96.30%,11,26,42.3,3.70%,0,1,0
Alex Caruso,LAL ,24,31,16,100%,14,26,53.8,63.5,53.80%,9,14,64.3,46.20%,5,12,41.7
Cheick Diallo,NOP ,21,26,15,100%,14,26,53.8,53.8,100%,14,26,53.8,0.00%,0,0,-
Jonathan Isaac,ORL ,20,27,15,100%,13,26,50,59.6,57.70%,8,15,53.3,42.30%,5,11,45.5
Salah Mejri,DAL ,31,42,17,100%,21,25,84,84,96.00%,21,24,87.5,4.00%,0,1,0
Shane Larkin,BOS ,25,32,13,100%,14,25,56,68,64.00%,8,16,50,36.00%,6,9,66.7
Danuel House,PHX ,24,18,12,100%,13,25,52,64,48.00%,7,12,58.3,52.00%,6,13,46.2
Nerlens Noel,DAL ,24,22,13,100%,11,25,44,44,100%,11,25,44,0.00%,0,0,-
Semi Ojeleye,BOS ,23,49,19,100%,9,25,36,48,24.00%,3,6,50,76.00%,6,19,31.6
Tyler Cavanaugh,ATL ,24,28,12,100%,13,24,54.2,66.7,37.50%,7,9,77.8,62.50%,6,15,40
Raul Neto,UTA ,26,27,18,100%,11,24,45.8,54.2,45.80%,7,11,63.6,54.20%,4,13,30.8
Kawhi Leonard,SAS ,26,7,7,100%,11,24,45.8,52.1,70.80%,8,17,47.1,29.20%,3,7,42.9
Brandon Paul,SAS ,27,19,13,100%,11,24,45.8,54.2,41.70%,7,10,70,58.30%,4,14,28.6
Timofey Mozgov,BKN ,31,17,13,100%,12,23,52.2,54.3,73.90%,11,17,64.7,26.10%,1,6,16.7
Jason Terry,MIL ,40,33,14,100%,8,23,34.8,47.8,21.70%,2,5,40,78.30%,6,18,33.3
Shaquille Harrison,PHX ,24,18,15,100%,10,22,45.5,47.7,77.30%,9,17,52.9,22.70%,1,5,20
Kenneth Faried,DEN ,28,16,7,100%,13,21,61.9,61.9,95.20%,13,20,65,4.80%,0,1,0
Brandan Wright,HOU ,30,22,15,100%,12,21,57.1,57.1,100%,12,21,57.1,0.00%,0,0,-
Joe Young,IND ,25,19,13,100%,9,21,42.9,50,42.90%,6,9,66.7,57.10%,3,12,25
Damyean Dotson,NYK ,24,16,11,100%,9,21,42.9,45.2,66.70%,8,14,57.1,33.30%,1,7,14.3
Glenn Robinson III,IND ,24,18,10,100%,7,21,33.3,38.1,61.90%,5,13,38.5,38.10%,2,8,25
Ramon Sessions,WAS ,32,16,12,100%,6,21,28.6,33.3,81.00%,4,17,23.5,19.00%,2,4,50
Antonio Blakeney,CHI ,21,13,11,100%,5,21,23.8,28.6,52.40%,3,11,27.3,47.60%,2,10,20
Tarik Black,HOU ,26,24,11,100%,12,20,60,62.5,90.00%,11,18,61.1,10.00%,1,2,50
Luke Kornet,NYK ,22,12,10,100%,8,20,40,47.5,35.00%,5,7,71.4,65.00%,3,13,23.1
Michael Carter-Williams,CHA ,26,39,12,100%,8,19,42.1,44.7,68.40%,7,13,53.8,31.60%,1,6,16.7
DeAndre Liggins,NOP ,30,33,15,100%,5,19,26.3,34.2,36.80%,2,7,28.6,63.20%,3,12,25
Ian Mahinmi,WAS ,31,48,12,100%,11,18,61.1,61.1,100%,11,18,61.1,0.00%,0,0,-
Ekpe Udoh,UTA ,31,42,14,100%,11,18,61.1,61.1,100%,11,18,61.1,0.00%,0,0,-
Troy Williams,NYK ,23,10,8,100%,9,18,50,55.6,66.70%,7,12,58.3,33.30%,2,6,33.3
Malik Beasley,DEN ,21,25,12,100%,6,18,33.3,41.7,55.60%,3,10,30,44.40%,3,8,37.5
Willy Hernangomez,CHA ,24,15,7,100%,10,17,58.8,58.8,88.20%,10,15,66.7,11.80%,0,2,0
Cody Zeller,CHA ,25,28,12,100%,10,17,58.8,58.8,100%,10,17,58.8,0.00%,0,0,-
Jahlil Okafor,BKN ,22,11,9,100%,10,17,58.8,58.8,94.10%,10,16,62.5,5.90%,0,1,0
Dante Exum,UTA ,22,13,10,100%,7,17,41.2,47.1,64.70%,5,11,45.5,35.30%,2,6,33.3
MarShon Brooks,MEM ,29,7,6,100%,10,16,62.5,71.9,68.80%,7,11,63.6,31.30%,3,5,60
JaKarr Sampson,SAC ,25,14,9,100%,9,16,56.3,59.4,93.80%,8,15,53.3,6.30%,1,1,100
Brandon Jennings,MIL ,28,11,8,100%,6,16,37.5,43.8,56.30%,4,9,44.4,43.80%,2,7,28.6
Aaron Harrison,DAL ,23,7,6,100%,5,16,31.3,43.8,25.00%,1,4,25,75.00%,4,12,33.3
Eric Moreland,DET ,26,32,9,100%,11,15,73.3,73.3,100%,11,15,73.3,0.00%,0,0,-
Khem Birch,ORL ,25,23,11,100%,10,15,66.7,66.7,100%,10,15,66.7,0.00%,0,0,-
Andrew White III,ATL ,24,12,7,100%,10,15,66.7,93.3,26.70%,2,4,50,73.30%,8,11,72.7
Boban Marjanovic,LAC ,29,16,7,100%,9,15,60,60,100%,9,15,60,0.00%,0,0,-
Lucas Nogueira,TOR ,25,17,9,100%,8,15,53.3,53.3,73.30%,8,11,72.7,26.70%,0,4,0
Kyle Collinsworth,DAL ,26,16,8,100%,7,15,46.7,50,73.30%,6,11,54.5,26.70%,1,4,25
Johnathan Motley,DAL ,23,5,5,100%,9,14,64.3,64.3,100%,9,14,64.3,0.00%,0,0,-
Jordan Mickey,MIA ,23,11,9,100%,8,14,57.1,57.1,92.90%,8,13,61.5,7.10%,0,1,0
TJ Leaf,IND ,21,20,8,100%,7,14,50,60.7,50.00%,4,7,57.1,50.00%,3,7,42.9
Alec Peters,PHX ,23,8,5,100%,6,14,42.9,60.7,7.10%,1,1,100,92.90%,5,13,38.5
Malachi Richardson,TOR ,22,12,7,100%,2,14,14.3,17.9,35.70%,1,5,20,64.30%,1,9,11.1
Isaiah Whitehead,BKN ,23,8,5,100%,8,13,61.5,65.4,84.60%,7,11,63.6,15.40%,1,2,50
Jamel Artis,ORL ,25,10,6,100%,5,13,38.5,42.3,61.50%,4,8,50,38.50%,1,5,20
Meyers Leonard,POR ,26,13,8,100%,4,13,30.8,34.6,61.50%,3,8,37.5,38.50%,1,5,20
Josh Magette,ATL ,28,10,9,100%,3,13,23.1,30.8,46.20%,1,6,16.7,53.80%,2,7,28.6
Rodney McGruder,MIA ,26,12,4,100%,7,12,58.3,75,33.30%,3,4,75,66.70%,4,8,50
Arron Afflalo,ORL ,32,27,7,100%,7,12,58.3,66.7,58.30%,5,7,71.4,41.70%,2,5,40
Iman Shumpert,SAC ,27,9,6,100%,5,12,41.7,50,33.30%,3,4,75,66.70%,2,8,25
Guerschon Yabusele,BOS ,22,8,5,100%,4,12,33.3,37.5,50.00%,3,6,50,50.00%,1,6,16.7
Rodney Purvis,ORL ,24,9,6,100%,3,12,25,29.2,50.00%,2,6,33.3,50.00%,1,6,16.7
Abdel Nader,BOS ,24,21,7,100%,2,12,16.7,16.7,58.30%,2,7,28.6,41.70%,0,5,0
Ivica Zubac,LAL ,21,18,7,100%,4,11,36.4,36.4,100%,4,11,36.4,0.00%,0,0,-
Aaron Brooks,MIN ,33,6,5,100%,3,11,27.3,31.8,54.50%,2,6,33.3,45.50%,1,5,20
Nigel Hayes,SAC ,23,5,5,100%,2,11,18.2,22.7,54.50%,1,6,16.7,45.50%,1,5,20
Ante Zizic,CLE ,21,8,5,100%,8,10,80,80,100%,8,10,80,0.00%,0,0,-
Gary Payton II,LAL ,25,10,6,100%,6,10,60,60,90.00%,6,9,66.7,10.00%,0,1,0
Mirza Teletovic,MIL ,32,5,4,100%,5,10,50,75,0.00%,0,0,-,100%,5,10,50
Briante Weber,MEM ,25,10,6,100%,5,10,50,50,80.00%,5,8,62.5,20.00%,0,2,0
Henry Ellenson,DET ,21,11,7,100%,4,10,40,45,60.00%,3,6,50,40.00%,1,4,25
John Holland,CLE ,29,6,3,100%,3,10,30,45,50.00%,0,5,0,50.00%,3,5,60
Jalen Jones,DAL ,25,7,5,100%,2,10,20,20,70.00%,2,7,28.6,30.00%,0,3,0
Andrew Bogut,LAL ,33,12,6,100%,7,9,77.8,77.8,100%,7,9,77.8,0.00%,0,0,-
Tony Allen,NOP ,36,16,6,100%,6,9,66.7,72.2,66.70%,5,6,83.3,33.30%,1,3,33.3
Jaylen Morris,ATL ,22,5,4,100%,5,9,55.6,61.1,44.40%,4,4,100,55.60%,1,5,20
Isaiah Hicks,NYK ,23,9,6,100%,5,9,55.6,61.1,77.80%,4,7,57.1,22.20%,1,2,50
Jason Smith,WAS ,32,12,5,100%,4,9,44.4,44.4,88.90%,4,8,50,11.10%,0,1,0
Kay Felder,DET ,23,6,4,100%,2,9,22.2,22.2,88.90%,2,8,25,11.10%,0,1,0
Ron Baker,NYK ,25,13,6,100%,2,9,22.2,33.3,22.20%,0,2,0,77.80%,2,7,28.6
Johnny O'Bryant III,CHA ,24,14,5,100%,5,8,62.5,68.8,87.50%,4,7,57.1,12.50%,1,1,100
Juancho Hernangomez,DEN ,22,9,5,100%,2,8,25,37.5,12.50%,0,1,0,87.50%,2,7,28.6
Okaro White,CLE ,25,6,4,100%,4,7,57.1,71.4,28.60%,2,2,100,71.40%,2,5,40
Derrick Jones Jr.,MIA ,21,9,5,100%,3,7,42.9,42.9,57.10%,3,4,75,42.90%,0,3,0
Jon Leuer,DET ,29,6,5,100%,3,7,42.9,42.9,100%,3,7,42.9,0.00%,0,0,-
Omari Johnson,MEM ,29,4,3,100%,3,7,42.9,57.1,28.60%,1,2,50,71.40%,2,5,40
Quincy Pondexter,CHI ,30,6,3,100%,2,7,28.6,28.6,71.40%,2,5,40,28.60%,0,2,0
Bobby Brown,HOU ,33,2,2,100%,2,7,28.6,42.9,28.60%,0,2,0,71.40%,2,5,40
Davon Reed,PHX ,22,10,6,100%,2,7,28.6,35.7,28.60%,1,2,50,71.40%,1,5,20
Jake Layman,POR ,24,4,3,100%,2,7,28.6,28.6,85.70%,2,6,33.3,14.30%,0,1,0
Solomon Hill,NOP ,27,8,6,100%,0,7,0,0,71.40%,0,5,0,28.60%,0,2,0
Marcus Georges-Hunt,MIN ,24,11,3,100%,4,6,66.7,75,83.30%,3,5,60,16.70%,1,1,100
Caleb Swanigan,POR ,21,8,5,100%,4,6,66.7,66.7,100%,4,6,66.7,0.00%,0,0,-
Travis Wear,LAL ,27,11,6,100%,1,6,16.7,25,33.30%,0,2,0,66.70%,1,4,25
Xavier Rathan-Mayes,MEM ,24,5,4,100%,1,6,16.7,16.7,66.70%,1,4,25,33.30%,0,2,0
Dakari Johnson,OKC ,22,7,5,100%,3,5,60,60,100%,3,5,60,0.00%,0,0,-
Brice Johnson,MEM ,23,3,3,100%,2,5,40,40,100%,2,5,40,0.00%,0,0,-
Alan Williams,PHX ,25,4,2,100%,2,5,40,40,100%,2,5,40,0.00%,0,0,-
Darrell Arthur,DEN ,30,6,4,100%,2,5,40,50,40.00%,1,2,50,60.00%,1,3,33.3
Bruno Caboclo,SAC ,22,4,3,100%,0,5,0,0,40.00%,0,2,0,60.00%,0,3,0
Marquis Teague,MEM ,25,3,2,100%,2,4,50,62.5,50.00%,1,2,50,50.00%,1,2,50
Damian Jones,GSW ,22,4,2,100%,2,4,50,50,100%,2,4,50,0.00%,0,0,-
Damien Wilkins,IND ,38,5,2,100%,2,4,50,75,50.00%,0,2,0,50.00%,2,2,100
James Young,PHI ,22,4,3,100%,2,4,50,75,0.00%,0,0,-,100%,2,4,50
Andre Ingram,LAL ,32,2,2,100%,1,4,25,37.5,50.00%,0,2,0,50.00%,1,2,50
London Perrantes,CLE ,23,1,1,100%,0,4,0,0,100%,0,4,0,0.00%,0,0,-
Ryan Arcidiacono,CHI ,24,11,4,100%,0,4,0,0,0.00%,0,0,-,100%,0,4,0
Jack Cooley,SAC ,27,5,2,100%,2,3,66.7,66.7,100%,2,3,66.7,0.00%,0,0,-
David West,GSW ,37,3,1,100%,2,3,66.7,66.7,100%,2,3,66.7,0.00%,0,0,-
James Webb III,BKN ,24,6,3,100%,1,3,33.3,33.3,33.30%,1,1,100,66.70%,0,2,0
Furkan Korkmaz,PHI ,20,1,1,100%,1,3,33.3,33.3,33.30%,1,1,100,66.70%,0,2,0
Omer Asik,CHI ,31,14,3,100%,1,3,33.3,33.3,100%,1,3,33.3,0.00%,0,0,-
Milton Doyle,BKN ,24,5,3,100%,1,3,33.3,33.3,33.30%,1,1,100,66.70%,0,2,0
Josh Gray,PHX ,24,4,3,100%,0,3,0,0,33.30%,0,1,0,66.70%,0,2,0
Derrick Walton Jr.,MIA ,23,4,3,100%,0,3,0,0,0.00%,0,0,-,100%,0,3,0
Georgios Papagiannis,POR ,20,5,2,100%,1,2,50,50,100%,1,2,50,0.00%,0,0,-
Devin Robinson,WAS ,23,1,1,100%,1,2,50,50,100%,1,2,50,0.00%,0,0,-
Wade Baldwin IV,POR ,22,4,2,100%,1,2,50,75,50.00%,0,1,0,50.00%,1,1,100
Derrick White,SAS ,23,5,1,100%,1,2,50,50,100%,1,2,50,0.00%,0,0,-
Jabari Bird,BOS ,23,3,2,100%,0,2,0,0,50.00%,0,1,0,50.00%,0,1,0
Darrun Hilliard,SAS ,25,5,2,100%,0,2,0,0,100%,0,2,0,0.00%,0,0,-
Malcolm Miller,TOR ,25,3,2,100%,0,2,0,0,50.00%,0,1,0,50.00%,0,1,0
Nick Collison,OKC ,37,1,1,100%,1,1,100,100,100%,1,1,100,0.00%,0,0,-
Chris McCullough,WAS ,23,1,1,100%,1,1,100,100,100%,1,1,100,0.00%,0,0,-
Luol Deng,LAL ,33,1,1,100%,1,1,100,100,100%,1,1,100,0.00%,0,0,-
Jameel Warney,DAL ,24,2,1,100%,1,1,100,100,100%,1,1,100,0.00%,0,0,-
Jordan Crawford,NOP ,29,2,1,100%,1,1,100,100,100%,1,1,100,0.00%,0,0,-
Daniel Hamilton,OKC ,22,1,1,100%,1,1,100,100,100%,1,1,100,0.00%,0,0,-
Monte Morris,DEN ,22,1,1,100%,1,1,100,100,100%,1,1,100,0.00%,0,0,-
Richard Jefferson,DEN ,37,5,1,100%,0,1,0,0,100%,0,1,0,0.00%,0,0,-
Xavier Silas,BOS ,30,1,1,100%,0,1,0,0,0.00%,0,0,-,100%,0,1,0
Thomas Bryant,LAL ,20,1,1,100%,0,1,0,0,0.00%,0,0,-,100%,0,1,0
Jonathan Gibson,BOS ,30,1,1,100%,0,1,0,0,0.00%,0,0,-,100%,0,1,0
Vander Blue,LAL ,25,2,1,100%,0,1,0,0,0.00%,0,0,-,100%,0,1,0
Jeremy Lin,BKN ,29,1,1,100%,0,1,0,0,100%,0,1,0,0.00%,0,0,-
Demetrius Jackson,PHI ,23,2,1,100%,0,1,0,0,0.00%,0,0,-,100%,0,1,0
Zhou Qi,HOU ,22,1,1,100%,0,1,0,0,0.00%,0,0,-,100%,0,1,0
Julyan Stone,CHA ,29,6,1,100%,0,1,0,0,0.00%,0,0,-,100%,0,1,0
Rashad Vaughn,ORL ,21,7,1,100%,0,1,0,0,0.00%,0,0,-,100%,0,1,0
