name,team,age,gp,g,fgfreq,fgm,fga,fgp,efgp,2fgfreq,2fgm,2fga,2fgp,3pfreq,3pm,3pa,3pp
Lou Williams,LAC ,31,76,76,100%,200,383,52.2,61.4,54.80%,130,210,61.9,45.20%,70,173,40.5
Russell Westbrook,OKC ,29,71,68,100%,177,363,48.8,54.3,70.00%,137,254,53.9,30.00%,40,109,36.7
CJ McCollum,POR ,26,80,75,100%,168,358,46.9,52.4,69.60%,129,249,51.8,30.40%,39,109,35.8
LeBron James,CLE ,33,71,70,100%,192,353,54.4,59.5,67.70%,156,239,65.3,32.30%,36,114,31.6
Donovan Mitchell,UTA ,21,74,71,100%,169,344,49.1,56.4,57.80%,119,199,59.8,42.20%,50,145,34.5
Bradley Beal,WAS ,24,70,69,100%,125,315,39.7,46.7,57.50%,81,181,44.8,42.50%,44,134,32.8
Kemba Walker,CHA ,28,70,67,100%,135,301,44.9,53.5,51.50%,83,155,53.5,48.50%,52,146,35.6
Buddy Hield,SAC ,24,74,71,100%,138,298,46.3,56,52.70%,80,157,51,47.30%,58,141,41.1
Damian Lillard,POR ,27,69,67,100%,144,294,49,56.1,56.80%,102,167,61.1,43.20%,42,127,33.1
Giannis Antetokounmpo,MIL ,23,69,67,100%,161,287,56.1,58,87.10%,150,250,60,12.90%,11,37,29.7
Victor Oladipo,IND ,26,67,66,100%,140,287,48.8,55.2,57.80%,103,166,62,42.20%,37,121,30.6
James Harden,HOU ,28,64,63,100%,118,280,42.1,52.5,44.60%,60,125,48,55.40%,58,155,37.4
Kyle Kuzma,LAL ,22,72,70,100%,138,279,49.5,58.4,51.60%,88,144,61.1,48.40%,50,135,37
Jordan Clarkson,CLE ,25,78,76,100%,134,276,48.6,56.2,60.90%,92,168,54.8,39.10%,42,108,38.9
Khris Middleton,MIL ,26,77,75,100%,131,276,47.5,54,59.80%,95,165,57.6,40.20%,36,111,32.4
Anthony Davis,NOP ,25,65,63,100%,145,275,52.7,54.7,86.50%,134,238,56.3,13.50%,11,37,29.7
Klay Thompson,GSW ,28,70,69,100%,133,275,48.4,58.5,52.70%,77,145,53.1,47.30%,56,130,43.1
Karl-Anthony Towns,MIN ,22,80,78,100%,148,257,57.6,64,70.00%,115,180,63.9,30.00%,33,77,42.9
Jeremy Lamb,CHA ,25,77,75,100%,126,251,50.2,55,70.10%,102,176,58,29.90%,24,75,32
Jimmy Butler,MIN ,28,56,55,100%,109,251,43.4,47,74.50%,91,187,48.7,25.50%,18,64,28.1
LaMarcus Aldridge,SAS ,32,63,62,100%,130,248,52.4,52.6,96.40%,129,239,54,3.60%,1,9,11.1
Paul George,OKC ,28,74,70,100%,103,244,42.2,52.7,45.50%,52,111,46.8,54.50%,51,133,38.3
Jrue Holiday,NOP ,27,73,68,100%,126,241,52.3,57.7,71.40%,100,172,58.1,28.60%,26,69,37.7
Will Barton,DEN ,27,77,72,100%,102,241,42.3,47.7,59.30%,76,143,53.1,40.70%,26,98,26.5
Kelly Oubre Jr.,WAS ,22,80,73,100%,111,239,46.4,54.8,49.80%,71,119,59.7,50.20%,40,120,33.3
Jamal Crawford,MIN ,38,78,73,100%,98,236,41.5,49.8,55.10%,59,130,45.4,44.90%,39,106,36.8
Bobby Portis,CHI ,23,69,64,100%,121,230,52.6,58.3,71.70%,95,165,57.6,28.30%,26,65,40
DeMar DeRozan,TOR ,28,59,57,100%,113,229,49.3,51.1,84.70%,105,194,54.1,15.30%,8,35,22.9
Devin Booker,PHX ,21,50,50,100%,97,226,42.9,49.3,61.50%,68,139,48.9,38.50%,29,87,33.3
Lance Stephenson,IND ,27,80,68,100%,113,225,50.2,54.9,69.80%,92,157,58.6,30.20%,21,68,30.9
Fred VanVleet,TOR ,24,74,72,100%,95,222,42.8,53.4,45.50%,48,101,47.5,54.50%,47,121,38.8
Joel Embiid,PHI ,24,57,54,100%,110,220,50,53.4,76.80%,95,169,56.2,23.20%,15,51,29.4
Eric Gordon,HOU ,29,68,64,100%,98,220,44.5,57.7,32.30%,40,71,56.3,67.70%,58,149,38.9
Tyreke Evans,MEM ,28,50,48,100%,96,220,43.6,50.2,59.10%,67,130,51.5,40.90%,29,90,32.2
Jamal Murray,DEN ,21,68,61,100%,106,219,48.4,54.8,59.80%,78,131,59.5,40.20%,28,88,31.8
Wayne Ellington,MIA ,30,72,68,100%,92,219,42,59.6,15.10%,15,33,45.5,84.90%,77,186,41.4
Spencer Dinwiddie,BKN ,25,71,64,100%,85,218,39,45.4,53.20%,57,116,49.1,46.80%,28,102,27.5
Eric Bledsoe,MIL ,28,65,61,100%,109,217,50.2,56.2,60.80%,83,132,62.9,39.20%,26,85,30.6
Yogi Ferrell,DAL ,25,80,73,100%,106,217,48.8,62.9,41.90%,45,91,49.5,58.10%,61,126,48.4
Kyrie Irving,BOS ,26,49,48,100%,105,217,48.4,53.9,61.80%,81,134,60.4,38.20%,24,83,28.9
Josh Richardson,MIA ,24,74,70,100%,103,217,47.5,53.2,64.50%,78,140,55.7,35.50%,25,77,32.5
TJ Warren,PHX ,24,60,58,100%,116,215,54,55.1,90.20%,111,194,57.2,9.80%,5,21,23.8
Michael Beasley,NYK ,29,59,54,100%,106,210,50.5,53.1,88.60%,95,186,51.1,11.40%,11,24,45.8
Josh Jackson,PHX ,21,70,63,100%,97,208,46.6,49.5,74.00%,85,154,55.2,26.00%,12,54,22.2
Dwyane Wade,MIA ,36,66,61,100%,89,208,42.8,45,81.70%,80,170,47.1,18.30%,9,38,23.7
Terry Rozier,BOS ,24,76,63,100%,94,207,45.4,56.5,46.90%,48,97,49.5,53.10%,46,110,41.8
Frank Kaminsky,CHA ,25,77,68,100%,91,206,44.2,49.3,60.20%,70,124,56.5,39.80%,21,82,25.6
Raymond Felton,OKC ,33,80,72,100%,85,204,41.7,47.5,61.80%,61,126,48.4,38.20%,24,78,30.8
DeMarcus Cousins,NOP ,27,45,45,100%,97,203,47.8,53,63.50%,76,129,58.9,36.50%,21,74,28.4
Harrison Barnes,DAL ,25,69,66,100%,95,202,47,51.5,70.30%,77,142,54.2,29.70%,18,60,30
Mario Hezonja,ORL ,23,66,60,100%,94,196,48,57.4,49.50%,57,97,58.8,50.50%,37,99,37.4
J.J. Barea,DAL ,33,65,62,100%,87,196,44.4,52.3,51.00%,56,100,56,49.00%,31,96,32.3
Chris Paul,HOU ,33,57,57,100%,99,195,50.8,59.5,57.40%,65,112,58,42.60%,34,83,41
Nikola Jokic,DEN ,23,65,61,100%,89,195,45.6,50.3,71.30%,71,139,51.1,28.70%,18,56,32.1
Kyle Korver,CLE ,37,68,64,100%,89,192,46.4,65.1,15.60%,17,30,56.7,84.40%,72,162,44.4
Marc Gasol,MEM ,33,64,55,100%,70,191,36.6,42.1,57.60%,49,110,44.5,42.40%,21,81,25.9
Ben Simmons,PHI ,21,73,65,100%,113,190,59.5,59.5,98.90%,113,188,60.1,1.10%,0,2,0
Dennis Schroder,ATL ,24,54,52,100%,93,190,48.9,51.1,81.60%,85,155,54.8,18.40%,8,35,22.9
Dennis Smith Jr.,DAL ,20,64,55,100%,88,185,47.6,54.1,61.60%,64,114,56.1,38.40%,24,71,33.8
Nick Young,GSW ,32,69,63,100%,74,185,40,50,35.70%,37,66,56.1,64.30%,37,119,31.1
Kevin Durant,GSW ,29,56,53,100%,97,183,53,62.8,59.00%,61,108,56.5,41.00%,36,75,48
Andrew Wiggins,MIN ,23,79,66,100%,82,182,45.1,51.4,65.90%,59,120,49.2,34.10%,23,62,37.1
Caris LeVert,BKN ,23,66,62,100%,86,181,47.5,53,63.50%,66,115,57.4,36.50%,20,66,30.3
Malik Monk,CHA ,20,56,51,100%,68,180,37.8,48.3,35.60%,30,64,46.9,64.40%,38,116,32.8
Rodney Hood,CLE ,25,53,50,100%,73,179,40.8,46.9,57.50%,51,103,49.5,42.50%,22,76,28.9
Taurean Prince,ATL ,24,66,55,100%,93,177,52.5,63.6,48.60%,54,86,62.8,51.40%,39,91,42.9
Cory Joseph,IND ,26,81,70,100%,83,177,46.9,53.4,61.00%,60,108,55.6,39.00%,23,69,33.3
JJ Redick,PHI ,33,63,61,100%,82,177,46.3,58.2,42.40%,40,75,53.3,57.60%,42,102,41.2
Robert Covington,PHI ,27,72,64,100%,70,177,39.5,49.4,36.20%,35,64,54.7,63.80%,35,113,31
Denzel Valentine,CHI ,24,70,61,100%,73,176,41.5,50.3,48.90%,42,86,48.8,51.10%,31,90,34.4
Jeff Green,CLE ,31,74,66,100%,83,175,47.4,52,63.40%,67,111,60.4,36.60%,16,64,25
Trey Lyles,DEN ,22,70,60,100%,99,174,56.9,63.5,67.20%,76,117,65,32.80%,23,57,40.4
Kristaps Porzingis,NYK ,22,42,40,100%,80,174,46,51.4,76.40%,61,133,45.9,23.60%,19,41,46.3
Goran Dragic,MIA ,32,62,56,100%,75,173,43.4,48.8,69.40%,56,120,46.7,30.60%,19,53,35.8
Kelly Olynyk,MIA ,27,68,56,100%,98,171,57.3,64.9,59.10%,72,101,71.3,40.90%,26,70,37.1
CJ Miles,TOR ,31,66,61,100%,72,171,42.1,57,21.60%,21,37,56.8,78.40%,51,134,38.1
Ish Smith,DET ,29,75,64,100%,88,170,51.8,54.7,86.50%,78,147,53.1,13.50%,10,23,43.5
Carmelo Anthony,OKC ,33,66,61,100%,66,170,38.8,45.6,50.60%,43,86,50,49.40%,23,84,27.4
Jayson Tatum,BOS ,20,71,62,100%,97,169,57.4,63.6,74.60%,76,126,60.3,25.40%,21,43,48.8
David West,GSW ,37,72,67,100%,97,169,57.4,58,97.00%,95,164,57.9,3.00%,2,5,40
Delon Wright,TOR ,26,65,61,100%,82,169,48.5,56.5,59.80%,55,101,54.5,40.20%,27,68,39.7
Bryn Forbes,SAS ,24,75,65,100%,76,169,45,53.6,54.40%,47,92,51.1,45.60%,29,77,37.7
Montrezl Harrell,LAC ,24,71,63,100%,115,168,68.5,68.5,99.40%,115,167,68.9,0.60%,0,1,0
De'Aaron Fox,SAC ,20,59,53,100%,83,168,49.4,52.1,83.90%,74,141,52.5,16.10%,9,27,33.3
Dirk Nowitzki,DAL ,39,67,63,100%,81,168,48.2,60.1,47.60%,41,80,51.3,52.40%,40,88,45.5
Kent Bazemore,ATL ,28,57,56,100%,77,168,45.8,55.7,51.80%,44,87,50.6,48.20%,33,81,40.7
Pascal Siakam,TOR ,24,80,67,100%,90,167,53.9,55.7,72.50%,84,121,69.4,27.50%,6,46,13
Blake Griffin,DET ,29,50,50,100%,72,166,43.4,49.1,68.10%,53,113,46.9,31.90%,19,53,35.8
Kyle Lowry,TOR ,32,60,56,100%,76,165,46.1,58.5,40.00%,35,66,53,60.00%,41,99,41.4
Andre Drummond,DET ,24,70,58,100%,99,164,60.4,60.4,100%,99,164,60.4,0.00%,0,0,-
Jonathon Simmons,ORL ,28,63,55,100%,82,164,50,54.3,71.30%,68,117,58.1,28.70%,14,47,29.8
Jodie Meeks,WAS ,30,68,56,100%,72,162,44.4,54.9,42.00%,38,68,55.9,58.00%,34,94,36.2
Shabazz Napier,POR ,26,71,65,100%,77,160,48.1,55.6,60.00%,53,96,55.2,40.00%,24,64,37.5
Dejounte Murray,SAS ,21,76,64,100%,77,160,48.1,49.4,95.00%,73,152,48,5.00%,4,8,50
E'Twaun Moore,NOP ,29,72,61,100%,88,159,55.3,61.3,66.00%,69,105,65.7,34.00%,19,54,35.2
Marco Belinelli,PHI ,32,73,65,100%,75,159,47.2,58.8,41.50%,38,66,57.6,58.50%,37,93,39.8
Bogdan Bogdanovic,SAC ,25,62,54,100%,70,158,44.3,53.2,51.30%,42,81,51.9,48.70%,28,77,36.4
Dillon Brooks,MEM ,22,72,62,100%,70,158,44.3,51.6,60.80%,47,96,49,39.20%,23,62,37.1
Gary Harris,DEN ,23,61,57,100%,66,158,41.8,49.7,48.70%,41,77,53.2,51.30%,25,81,30.9
Tobias Harris,LAC ,25,68,62,100%,77,157,49,58,59.90%,49,94,52.1,40.10%,28,63,44.4
Nikola Mirotic,NOP ,27,49,45,100%,77,157,49,62.7,35.00%,34,55,61.8,65.00%,43,102,42.2
D'Angelo Russell,BKN ,22,40,38,100%,66,157,42,49,54.10%,44,85,51.8,45.90%,22,72,30.6
Domantas Sabonis,IND ,22,72,61,100%,90,153,58.8,60.1,94.80%,86,145,59.3,5.20%,4,8,50
Mike Scott,WAS ,29,71,62,100%,81,151,53.6,59.6,68.90%,63,104,60.6,31.10%,18,47,38.3
Bojan Bogdanovic,IND ,29,70,61,100%,81,151,53.6,66.2,39.70%,43,60,71.7,60.30%,38,91,41.8
Joe Harris,BKN ,26,77,68,100%,78,150,52,65,34.00%,39,51,76.5,66.00%,39,99,39.4
Evan Fournier,ORL ,25,49,45,100%,60,150,40,49.3,42.00%,32,63,50.8,58.00%,28,87,32.2
Willie Cauley-Stein,SAC ,24,63,55,100%,90,149,60.4,61.1,97.30%,88,145,60.7,2.70%,2,4,50
Patty Mills,SAS ,29,72,61,100%,65,149,43.6,56.7,31.50%,26,47,55.3,68.50%,39,102,38.2
Allen Crabbe,BKN ,26,67,56,100%,64,149,43,55,30.20%,28,45,62.2,69.80%,36,104,34.6
Frank Ntilikina,NYK ,19,72,60,100%,55,149,36.9,42.3,67.10%,39,100,39,32.90%,16,49,32.7
Al Horford,BOS ,31,59,53,100%,75,148,50.7,59.5,59.50%,49,88,55.7,40.50%,26,60,43.3
Ian Clark,NOP ,27,67,58,100%,65,148,43.9,49.3,59.50%,49,88,55.7,40.50%,16,60,26.7
Jerian Grant,CHI ,25,66,57,100%,60,148,40.5,50,45.30%,32,67,47.8,54.70%,28,81,34.6
Tim Hardaway Jr.,NYK ,26,50,44,100%,57,147,38.8,48,46.90%,30,69,43.5,53.10%,27,78,34.6
Dario Saric,PHI ,24,70,62,100%,59,146,40.4,51,43.80%,28,64,43.8,56.20%,31,82,37.8
Austin Rivers,LAC ,25,55,46,100%,71,145,49,59,51.00%,42,74,56.8,49.00%,29,71,40.8
Julius Randle,LAL ,23,69,61,100%,96,144,66.7,68.1,88.90%,92,128,71.9,11.10%,4,16,25
Anthony Tolliver,DET ,32,75,62,100%,61,143,42.7,57,23.80%,20,34,58.8,76.20%,41,109,37.6
Jerami Grant,OKC ,24,79,62,100%,87,142,61.3,65.8,73.90%,74,105,70.5,26.10%,13,37,35.1
Luke Kennard,DET ,21,69,55,100%,72,141,51.1,59.9,55.30%,47,78,60.3,44.70%,25,63,39.7
Kentavious Caldwell-Pope,LAL ,25,61,50,100%,63,141,44.7,55.7,46.10%,32,65,49.2,53.90%,31,76,40.8
Reggie Jackson,DET ,28,37,37,100%,63,141,44.7,47.5,74.50%,55,105,52.4,25.50%,8,36,22.2
Emmanuel Mudiay,NYK ,22,54,46,100%,61,141,43.3,48.6,70.90%,46,100,46,29.10%,15,41,36.6
Jusuf Nurkic,POR ,23,65,57,100%,76,139,54.7,54.7,100%,76,139,54.7,0.00%,0,0,-
Doug McDermott,DAL ,26,76,61,100%,70,136,51.5,60.3,57.40%,46,78,59,42.60%,24,58,41.4
Ersan Ilyasova,PHI ,31,60,52,100%,67,136,49.3,57.4,57.40%,45,78,57.7,42.60%,22,58,37.9
Darius Miller,NOP ,28,71,56,100%,64,136,47.1,64,23.50%,18,32,56.3,76.50%,46,104,44.2
Shelvin Mack,ORL ,28,65,55,100%,62,136,45.6,50.7,66.90%,48,91,52.7,33.10%,14,45,31.1
Frank Mason,SAC ,24,49,46,100%,57,136,41.9,48.2,75.00%,40,102,39.2,25.00%,17,34,50
Malcolm Brogdon,MIL ,25,43,40,100%,69,134,51.5,56.3,69.40%,56,93,60.2,30.60%,13,41,31.7
James Johnson,MIA ,31,62,52,100%,74,131,56.5,61.8,70.20%,60,92,65.2,29.80%,14,39,35.9
Kris Dunn,CHI ,24,44,40,100%,68,131,51.9,56.5,76.30%,56,100,56,23.70%,12,31,38.7
Marreese Speights,ORL ,30,42,38,100%,48,131,36.6,48.5,29.00%,17,38,44.7,71.00%,31,93,33.3
Draymond Green,GSW ,28,60,52,100%,66,129,51.2,58.9,55.00%,46,71,64.8,45.00%,20,58,34.5
Rudy Gay,SAS ,31,50,46,100%,60,129,46.5,50,73.60%,51,95,53.7,26.40%,9,34,26.5
Lauri Markkanen,CHI ,21,52,48,100%,54,129,41.9,52.7,41.10%,26,53,49.1,58.90%,28,76,36.8
Trevor Ariza,HOU ,32,64,56,100%,49,129,38,52.7,16.30%,11,21,52.4,83.70%,38,108,35.2
Gerald Green,HOU ,32,39,35,100%,48,129,37.2,49.2,30.20%,17,39,43.6,69.80%,31,90,34.4
Wesley Matthews,DAL ,31,57,51,100%,47,129,36.4,48.4,33.30%,16,43,37.2,66.70%,31,86,36
Troy Daniels,PHX ,26,69,54,100%,48,128,37.5,52.7,19.50%,9,25,36,80.50%,39,103,37.9
Thaddeus Young,IND ,29,68,49,100%,62,127,48.8,53.1,74.80%,51,95,53.7,25.20%,11,32,34.4
Tyler Johnson,MIA ,26,62,53,100%,51,126,40.5,50,46.80%,27,59,45.8,53.20%,24,67,35.8
Trey Burke,NYK ,25,34,32,100%,68,124,54.8,61.7,67.70%,51,84,60.7,32.30%,17,40,42.5
John Wall,WAS ,27,36,34,100%,50,124,40.3,45.6,68.50%,37,85,43.5,31.50%,13,39,33.3
Rondae Hollis-Jefferson,BKN ,23,56,43,100%,61,123,49.6,50,93.50%,60,115,52.2,6.50%,1,8,12.5
Brandon Ingram,LAL ,20,54,47,100%,61,123,49.6,51.6,84.60%,56,104,53.8,15.40%,5,19,26.3
Tyler Dorsey,ATL ,22,51,45,100%,60,123,48.8,61.8,47.20%,28,58,48.3,52.80%,32,65,49.2
Aaron Gordon,ORL ,22,46,42,100%,49,123,39.8,45.5,48.80%,35,60,58.3,51.20%,14,63,22.2
Sean Kilpatrick,CHI ,28,42,34,100%,50,122,41,50.4,49.20%,27,60,45,50.80%,23,62,37.1
Derrick Favors,UTA ,26,69,52,100%,82,121,67.8,68.2,95.00%,81,115,70.4,5.00%,1,6,16.7
Alec Burks,UTA ,26,53,43,100%,64,121,52.9,61.6,57.90%,43,70,61.4,42.10%,21,51,41.2
Isaiah Taylor,ATL ,23,65,46,100%,60,121,49.6,51.2,83.50%,56,101,55.4,16.50%,4,20,20
Norman Powell,TOR ,25,55,44,100%,54,121,44.6,49.6,56.20%,42,68,61.8,43.80%,12,53,22.6
DeMarre Carroll,BKN ,31,63,56,100%,55,120,45.8,57.1,41.70%,28,50,56,58.30%,27,70,38.6
Joe Ingles,UTA ,30,75,58,100%,52,120,43.3,57.1,27.50%,19,33,57.6,72.50%,33,87,37.9
Jeff Teague,MIN ,29,64,55,100%,52,120,43.3,49.2,64.20%,38,77,49.4,35.80%,14,43,32.6
Langston Galloway,DET ,26,49,43,100%,48,120,40,51.7,27.50%,20,33,60.6,72.50%,28,87,32.2
John Collins,ATL ,20,68,54,100%,75,119,63,64.7,89.90%,71,107,66.4,10.10%,4,12,33.3
Clint Capela,HOU ,24,68,55,100%,86,117,73.5,73.5,100%,86,117,73.5,0.00%,0,0,-
Ricky Rubio,UTA ,27,70,54,100%,51,117,43.6,50.9,61.50%,34,72,47.2,38.50%,17,45,37.8
Davis Bertans,SAS ,25,71,52,100%,54,116,46.6,59.9,29.30%,23,34,67.6,70.70%,31,82,37.8
Tyler Ulis,PHX ,22,54,43,100%,50,115,43.5,47.8,70.40%,40,81,49.4,29.60%,10,34,29.4
Dwight Powell,DAL ,26,73,57,100%,73,114,64,66.7,82.50%,67,94,71.3,17.50%,6,20,30
Elfrid Payton,PHX ,24,49,45,100%,63,113,55.8,58.8,80.50%,56,91,61.5,19.50%,7,22,31.8
Nemanja Bjelica,MIN ,30,61,46,100%,57,113,50.4,61.1,48.70%,33,55,60,51.30%,24,58,41.4
Otto Porter Jr.,WAS ,24,62,50,100%,51,111,45.9,55.4,58.60%,30,65,46.2,41.40%,21,46,45.7
Marcus Morris,BOS ,28,47,42,100%,50,111,45,52.3,61.30%,34,68,50,38.70%,16,43,37.2
Mario Chalmers,MEM ,32,51,42,100%,44,111,39.6,48.6,46.80%,24,52,46.2,53.20%,20,59,33.9
Al-Farouq Aminu,POR ,27,57,44,100%,37,111,33.3,43.7,28.80%,14,32,43.8,71.20%,23,79,29.1
Courtney Lee,NYK ,32,56,47,100%,53,110,48.2,57.3,57.30%,33,63,52.4,42.70%,20,47,42.6
Josh Hart,LAL ,23,63,45,100%,52,110,47.3,58.2,43.60%,28,48,58.3,56.40%,24,62,38.7
Justise Winslow,MIA ,22,57,44,100%,49,109,45,50,70.60%,38,77,49.4,29.40%,11,32,34.4
Jakob Poeltl,TOR ,22,75,52,100%,80,108,74.1,74.5,98.10%,79,106,74.5,1.90%,1,2,50
David Nwaba,CHI ,25,64,48,100%,66,108,61.1,61.6,90.70%,65,98,66.3,9.30%,1,10,10
D.J. Augustin,ORL ,30,58,44,100%,47,107,43.9,57,31.80%,19,34,55.9,68.20%,28,73,38.4
Dragan Bender,PHX ,20,76,54,100%,44,107,41.1,54.2,29.00%,16,31,51.6,71.00%,28,76,36.8
Danny Green,SAS ,30,53,45,100%,39,106,36.8,49.1,35.80%,13,38,34.2,64.20%,26,68,38.2
Jaylen Brown,BOS ,21,51,45,100%,58,105,55.2,63.8,57.10%,40,60,66.7,42.90%,18,45,40
Skal Labissiere,SAC ,22,44,38,100%,55,104,52.9,55.8,88.50%,49,92,53.3,11.50%,6,12,50
Jae Crowder,UTA ,27,54,43,100%,45,100,45,52,50.00%,31,50,62,50.00%,14,50,28
Mike James,NOP ,27,32,30,100%,45,100,45,49,70.00%,37,70,52.9,30.00%,8,30,26.7
Justin Holiday,CHI ,29,49,40,100%,39,100,39,50.5,34.00%,16,34,47.1,66.00%,23,66,34.8
Nikola Vucevic,ORL ,27,46,41,100%,53,99,53.5,58.1,71.70%,44,71,62,28.30%,9,28,32.1
Ben McLemore,MEM ,25,45,35,100%,42,99,42.4,49.5,53.50%,28,53,52.8,46.50%,14,46,30.4
Stanley Johnson,DET ,21,55,46,100%,36,99,36.4,40.9,55.60%,27,55,49.1,44.40%,9,44,20.5
Sam Dekker,LAC ,24,61,45,100%,54,98,55.1,56.6,75.50%,51,74,68.9,24.50%,3,24,12.5
PJ Tucker,HOU ,33,76,55,100%,38,98,38.8,52.6,25.50%,11,25,44,74.50%,27,73,37
Marcus Smart,BOS ,24,50,40,100%,32,98,32.7,40.3,49.00%,17,48,35.4,51.00%,15,50,30
Andrew Harrison,MEM ,23,47,40,100%,46,97,47.4,54.6,58.80%,32,57,56.1,41.20%,14,40,35
Jarell Martin,MEM ,24,61,45,100%,45,97,46.4,52.6,69.10%,33,67,49.3,30.90%,12,30,40
Markieff Morris,WAS ,28,45,41,100%,48,96,50,52.6,72.90%,43,70,61.4,27.10%,5,26,19.2
James Ennis III,DET ,27,61,49,100%,45,96,46.9,54.7,56.30%,30,54,55.6,43.80%,15,42,35.7
Pau Gasol,SAS ,37,61,48,100%,42,96,43.8,45.3,80.20%,39,77,50.6,19.80%,3,19,15.8
JaMychal Green,MEM ,27,46,38,100%,47,95,49.5,53.7,72.60%,39,69,56.5,27.40%,8,26,30.8
Devin Harris,DEN ,35,63,49,100%,47,95,49.5,60.5,50.50%,26,48,54.2,49.50%,21,47,44.7
Wilson Chandler,DEN ,31,61,43,100%,40,95,42.1,47.9,62.10%,29,59,49.2,37.90%,11,36,30.6
Shaun Livingston,GSW ,32,63,48,100%,49,94,52.1,52.1,100%,49,94,52.1,0.00%,0,0,-
T.J. McConnell,PHI ,26,69,49,100%,47,94,50,52.7,86.20%,42,81,51.9,13.80%,5,13,38.5
Tomas Satoransky,WAS ,26,66,51,100%,52,93,55.9,62.9,73.10%,39,68,57.4,26.90%,13,25,52
Pat Connaughton,POR ,25,76,47,100%,45,93,48.4,55.9,50.50%,31,47,66,49.50%,14,46,30.4
Avery Bradley,LAC ,27,40,34,100%,42,93,45.2,55.4,48.40%,23,45,51.1,51.60%,19,48,39.6
Isaiah Thomas,LAL ,29,25,25,100%,38,93,40.9,46.2,53.80%,28,50,56,46.20%,10,43,23.3
JR Smith,CLE ,32,58,43,100%,36,93,38.7,48.4,40.90%,18,38,47.4,59.10%,18,55,32.7
Royce O'Neale,UTA ,24,64,42,100%,36,93,38.7,47.8,48.40%,19,45,42.2,51.60%,17,48,35.4
Dewayne Dedmon,ATL ,28,55,44,100%,53,92,57.6,62.5,75.00%,44,69,63.8,25.00%,9,23,39.1
Darren Collison,IND ,30,51,38,100%,44,92,47.8,54.3,62.00%,32,57,56.1,38.00%,12,35,34.3
Evan Turner,POR ,29,62,46,100%,43,91,47.3,50,76.90%,38,70,54.3,23.10%,5,21,23.8
Patrick Patterson,OKC ,29,77,56,100%,40,91,44,59.3,29.70%,12,27,44.4,70.30%,28,64,43.8
Nicolas Batum,CHA ,29,50,40,100%,35,91,38.5,46.7,45.10%,20,41,48.8,54.90%,15,50,30
Manu Ginobili,SAS ,40,50,37,100%,47,90,52.2,60.6,52.20%,32,47,68.1,47.80%,15,43,34.9
Garrett Temple,SAC ,32,49,39,100%,40,90,44.4,57.2,41.10%,17,37,45.9,58.90%,23,53,43.4
Dwight Howard,CHA ,32,65,48,100%,53,89,59.6,59.6,96.60%,53,86,61.6,3.40%,0,3,0
Damyean Dotson,NYK ,24,36,31,100%,43,89,48.3,57.9,53.90%,26,48,54.2,46.10%,17,41,41.5
Justin Jackson,SAC ,23,52,39,100%,42,89,47.2,55.1,52.80%,28,47,59.6,47.20%,14,42,33.3
Tyus Jones,MIN ,22,80,49,100%,41,89,46.1,55.1,56.20%,25,50,50,43.80%,16,39,41
Ryan Anderson,HOU ,30,52,36,100%,40,89,44.9,57.9,36.00%,17,32,53.1,64.00%,23,57,40.4
Andre Iguodala,GSW ,34,58,45,100%,38,88,43.2,46,55.70%,33,49,67.3,44.30%,5,39,12.8
Stephen Curry,GSW ,30,33,31,100%,41,87,47.1,58.6,37.90%,21,33,63.6,62.10%,20,54,37
Jarrett Allen,BKN ,20,57,46,100%,55,86,64,65.1,94.20%,53,81,65.4,5.80%,2,5,40
Kyle Anderson,SAS ,24,65,44,100%,49,86,57,57.6,87.20%,48,75,64,12.80%,1,11,9.1
Gorgui Dieng,MIN ,28,71,42,100%,45,86,52.3,54.1,84.90%,42,73,57.5,15.10%,3,13,23.1
Dion Waiters,MIA ,26,22,21,100%,38,86,44.2,51.2,54.70%,26,47,55.3,45.30%,12,39,30.8
Lonzo Ball,LAL ,20,44,39,100%,28,86,32.6,40.1,41.90%,15,36,41.7,58.10%,13,50,26
Rajon Rondo,NOP ,32,44,36,100%,42,85,49.4,53.5,71.80%,35,61,57.4,28.20%,7,24,29.2
Jonas Jerebko,UTA ,31,55,43,100%,37,85,43.5,53.5,52.90%,20,45,44.4,47.10%,17,40,42.5
Quincy Acy,BKN ,27,59,49,100%,32,85,37.6,50.6,20.00%,10,17,58.8,80.00%,22,68,32.4
Alex Abrines,OKC ,24,61,45,100%,38,84,45.2,62.5,19.00%,9,16,56.3,81.00%,29,68,42.6
Mike Muscala,ATL ,26,51,41,100%,44,83,53,66.9,39.80%,21,33,63.6,60.20%,23,50,46
Serge Ibaka,TOR ,28,48,37,100%,39,83,47,49.4,75.90%,35,63,55.6,24.10%,4,20,20
Joe Johnson,HOU ,36,50,37,100%,35,83,42.2,47,59.00%,27,49,55.1,41.00%,8,34,23.5
Shane Larkin,BOS ,25,45,33,100%,34,83,41,46.4,53.00%,25,44,56.8,47.00%,9,39,23.1
Steven Adams,OKC ,24,65,45,100%,58,82,70.7,70.7,100%,58,82,70.7,0.00%,0,0,-
Alex Len,PHX ,24,56,39,100%,57,82,69.5,69.5,100%,57,82,69.5,0.00%,0,0,-
Kyle O'Quinn,NYK ,28,66,44,100%,54,82,65.9,66.5,96.30%,53,79,67.1,3.70%,1,3,33.3
Larry Nance Jr.,CLE ,25,51,38,100%,51,81,63,63,100%,51,81,63,0.00%,0,0,-
Deyonta Davis,MEM ,21,55,37,100%,48,81,59.3,59.3,100%,48,81,59.3,0.00%,0,0,-
Kosta Koufos,SAC ,29,57,46,100%,46,81,56.8,56.8,100%,46,81,56.8,0.00%,0,0,-
Jarrett Jack,NYK ,34,43,33,100%,40,81,49.4,51.9,82.70%,36,67,53.7,17.30%,4,14,28.6
Zach Collins,POR ,20,54,38,100%,36,81,44.4,53.1,58.00%,22,47,46.8,42.00%,14,34,41.2
Treveon Graham,CHA ,24,58,42,100%,26,81,32.1,39.5,48.10%,14,39,35.9,51.90%,12,42,28.6
Vince Carter,SAC ,41,40,35,100%,34,80,42.5,51.9,42.50%,19,34,55.9,57.50%,15,46,32.6
Zach Randolph,SAC ,36,30,28,100%,41,79,51.9,53.8,78.50%,38,62,61.3,21.50%,3,17,17.6
Luc Mbah a Moute,HOU ,31,55,41,100%,40,78,51.3,60.3,46.20%,26,36,72.2,53.80%,14,42,33.3
Marquese Chriss,PHX ,20,58,40,100%,40,77,51.9,59.1,59.70%,29,46,63,40.30%,11,31,35.5
Channing Frye,LAL ,35,44,37,100%,36,77,46.8,56.5,46.80%,21,36,58.3,53.20%,15,41,36.6
Jawun Evans,LAC ,21,44,31,100%,32,77,41.6,42.9,81.80%,30,63,47.6,18.20%,2,14,14.3
Michael Carter-Williams,CHA ,26,52,39,100%,26,77,33.8,39,70.10%,18,54,33.3,29.90%,8,23,34.8
John Henson,MIL ,27,54,41,100%,39,76,51.3,51.3,98.70%,39,75,52,1.30%,0,1,0
Noah Vonleh,CHI ,22,45,32,100%,33,76,43.4,49.3,65.80%,24,50,48,34.20%,9,26,34.6
Henry Ellenson,DET ,21,35,30,100%,30,76,39.5,47.4,56.60%,18,43,41.9,43.40%,12,33,36.4
Taj Gibson,MIN ,32,73,44,100%,54,75,72,72.7,94.70%,53,71,74.6,5.30%,1,4,25
Cristiano Felicio,CHI ,25,51,37,100%,49,75,65.3,65.3,98.70%,49,74,66.2,1.30%,0,1,0
Richaun Holmes,PHI ,24,42,33,100%,34,75,45.3,46,80.00%,33,60,55,20.00%,1,15,6.7
Jameer Nelson,DET ,36,45,35,100%,26,75,34.7,41.3,53.30%,16,40,40,46.70%,10,35,28.6
Greg Monroe,BOS ,27,37,30,100%,41,74,55.4,55.4,100%,41,74,55.4,0.00%,0,0,-
Bismack Biyombo,ORL ,25,62,41,100%,43,73,58.9,58.9,100%,43,73,58.9,0.00%,0,0,-
Willy Hernangomez,CHA ,24,44,31,100%,43,73,58.9,61.6,89.00%,39,65,60,11.00%,4,8,50
Trevor Booker,IND ,30,53,33,100%,41,73,56.2,58.9,87.70%,37,64,57.8,12.30%,4,9,44.4
Corey Brewer,OKC ,32,59,38,100%,34,73,46.6,50,68.50%,29,50,58,31.50%,5,23,21.7
Kevin Love,CLE ,29,45,34,100%,26,73,35.6,43.8,45.20%,14,33,42.4,54.80%,12,40,30
Bam Adebayo,MIA ,20,55,33,100%,48,72,66.7,66.7,100%,48,72,66.7,0.00%,0,0,-
Wayne Selden,MEM ,23,28,26,100%,36,72,50,63.2,44.40%,17,32,53.1,55.60%,19,40,47.5
Myles Turner,IND ,22,48,35,100%,31,72,43.1,45.8,77.80%,27,56,48.2,22.20%,4,16,25
Joe Young,IND ,25,43,28,100%,29,72,40.3,45.1,68.10%,22,49,44.9,31.90%,7,23,30.4
Paul Zipser,CHI ,24,45,35,100%,25,72,34.7,41,51.40%,16,37,43.2,48.60%,9,35,25.7
Reggie Bullock,DET ,27,47,33,100%,33,71,46.5,55.6,46.50%,20,33,60.6,53.50%,13,38,34.2
Tyler Ennis,LAL ,23,38,27,100%,30,71,42.3,45.1,78.90%,26,56,46.4,21.10%,4,15,26.7
Thon Maker,MIL ,21,59,38,100%,26,71,36.6,39.4,69.00%,22,49,44.9,31.00%,4,22,18.2
Boban Marjanovic,LAC ,29,29,25,100%,44,70,62.9,62.9,100%,44,70,62.9,0.00%,0,0,-
Malcolm Delaney,ATL ,29,46,30,100%,38,70,54.3,67.1,50.00%,20,35,57.1,50.00%,18,35,51.4
Milos Teodosic,LAC ,31,40,32,100%,31,70,44.3,55,30.00%,16,21,76.2,70.00%,15,49,30.6
Malik Beasley,DEN ,21,52,31,100%,31,70,44.3,52.9,55.70%,19,39,48.7,44.30%,12,31,38.7
Rudy Gobert,UTA ,25,52,37,100%,50,69,72.5,72.5,100%,50,69,72.5,0.00%,0,0,-
Zach LaVine,CHI ,23,17,16,100%,30,69,43.5,53.6,62.30%,16,43,37.2,37.70%,14,26,53.8
Johnny O'Bryant III,CHA ,24,27,25,100%,26,69,37.7,39.9,78.30%,23,54,42.6,21.70%,3,15,20
Omri Casspi,GSW ,29,44,31,100%,42,68,61.8,64.7,91.20%,38,62,61.3,8.80%,4,6,66.7
Tony Parker,SAS ,36,39,30,100%,39,68,57.4,58.8,94.10%,37,64,57.8,5.90%,2,4,50
Dwight Buycks,DET ,29,27,23,100%,35,68,51.5,56.6,75.00%,28,51,54.9,25.00%,7,17,41.2
Patrick McCaw,GSW ,22,48,32,100%,32,68,47.1,53.7,57.40%,23,39,59,42.60%,9,29,31
Daniel Theis,BOS ,26,48,35,100%,38,67,56.7,61.2,67.20%,32,45,71.1,32.80%,6,22,27.3
Terrance Ferguson,OKC ,20,44,25,100%,33,67,49.3,62.7,31.30%,15,21,71.4,68.70%,18,46,39.1
Timothe Luwawu-Cabarrot,PHI ,23,42,29,100%,33,66,50,63.6,40.90%,15,27,55.6,59.10%,18,39,46.2
Maurice Harkless,POR ,25,43,29,100%,37,65,56.9,65.4,70.80%,26,46,56.5,29.20%,11,19,57.9
Thabo Sefolosha,UTA ,34,35,29,100%,33,65,50.8,57.7,60.00%,24,39,61.5,40.00%,9,26,34.6
George Hill,CLE ,32,43,28,100%,32,65,49.2,62.3,49.20%,15,32,46.9,50.80%,17,33,51.5
Wesley Johnson,LAC ,30,52,35,100%,28,65,43.1,54.6,35.40%,13,23,56.5,64.60%,15,42,35.7
Mason Plumlee,DEN ,28,56,36,100%,43,64,67.2,67.2,100%,43,64,67.2,0.00%,0,0,-
Ian Mahinmi,WAS ,31,59,37,100%,42,64,65.6,65.6,100%,42,64,65.6,0.00%,0,0,-
Semi Ojeleye,BOS ,23,53,30,100%,27,63,42.9,55.6,38.10%,11,24,45.8,61.90%,16,39,41
Abdel Nader,BOS ,24,35,25,100%,23,63,36.5,46,50.80%,11,32,34.4,49.20%,12,31,38.7
DeAndre Jordan,LAC ,29,62,41,100%,42,62,67.7,67.7,100%,42,62,67.7,0.00%,0,0,-
Dwayne Bacon,CHA ,22,49,30,100%,22,62,35.5,35.5,80.60%,22,50,44,19.40%,0,12,0
Tony Snell,MIL ,26,60,37,100%,22,62,35.5,44.4,33.90%,11,21,52.4,66.10%,11,41,26.8
Joffrey Lauvergne,SAS ,26,46,26,100%,39,61,63.9,63.9,100%,39,61,63.9,0.00%,0,0,-
Michael Kidd-Gilchrist,CHA ,24,51,33,100%,30,61,49.2,49.2,100%,30,61,49.2,0.00%,0,0,-
Arron Afflalo,ORL ,32,40,31,100%,29,61,47.5,59,55.70%,15,34,44.1,44.30%,14,27,51.9
Jason Smith,WAS ,32,24,21,100%,26,61,42.6,43.4,78.70%,25,48,52.1,21.30%,1,13,7.7
Hassan Whiteside,MIA ,28,31,23,100%,40,60,66.7,67.5,98.30%,39,59,66.1,1.70%,1,1,100
Brook Lopez,LAL ,30,33,26,100%,29,60,48.3,55,60.00%,21,36,58.3,40.00%,8,24,33.3
Justin Anderson,PHI ,24,34,22,100%,19,59,32.2,37.3,47.50%,13,28,46.4,52.50%,6,31,19.4
Khem Birch,ORL ,25,35,23,100%,35,57,61.4,61.4,100%,35,57,61.4,0.00%,0,0,-
Maxi Kleber,DAL ,26,45,30,100%,29,57,50.9,57.9,54.40%,21,31,67.7,45.60%,8,26,30.8
Paul Millsap,DEN ,33,29,21,100%,27,57,47.4,50,68.40%,24,39,61.5,31.60%,3,18,16.7
Shabazz Muhammad,MIL ,25,36,25,100%,24,57,42.1,43.9,84.20%,22,48,45.8,15.80%,2,9,22.2
TJ Leaf,IND ,21,33,23,100%,24,57,42.1,45.6,77.20%,20,44,45.5,22.80%,4,13,30.8
Jerryd Bayless,PHI ,29,36,24,100%,23,57,40.4,51.8,33.30%,10,19,52.6,66.70%,13,38,34.2
Ed Davis,POR ,28,71,37,100%,37,56,66.1,66.1,100%,37,56,66.1,0.00%,0,0,-
Cheick Diallo,NOP ,21,44,27,100%,33,56,58.9,58.9,100%,33,56,58.9,0.00%,0,0,-
Wes Iwundu,ORL ,23,54,33,100%,33,56,58.9,61.6,82.10%,30,46,65.2,17.90%,3,10,30
Cedi Osman,CLE ,23,52,27,100%,29,56,51.8,60.7,51.80%,19,29,65.5,48.20%,10,27,37
Jabari Parker,MIL ,23,27,21,100%,28,56,50,56.3,67.90%,21,38,55.3,32.10%,7,18,38.9
Marvin Williams,CHA ,31,57,29,100%,21,56,37.5,46.4,39.30%,11,22,50,60.70%,10,34,29.4
Josh Huestis,OKC ,26,58,35,100%,20,56,35.7,47.3,26.80%,7,15,46.7,73.20%,13,41,31.7
Nik Stauskas,BKN ,24,30,21,100%,20,56,35.7,50.9,32.10%,3,18,16.7,67.90%,17,38,44.7
Sindarius Thornwell,LAC ,23,64,31,100%,30,55,54.5,60,72.70%,24,40,60,27.30%,6,15,40
Dante Cunningham,BKN ,31,52,36,100%,26,55,47.3,53.6,56.40%,19,31,61.3,43.60%,7,24,29.2
Enes Kanter,NYK ,26,40,25,100%,31,54,57.4,57.4,98.10%,31,53,58.5,1.90%,0,1,0
Quinn Cook,GSW ,25,31,23,100%,28,54,51.9,61.1,57.40%,18,31,58.1,42.60%,10,23,43.5
Raul Neto,UTA ,26,35,24,100%,27,54,50,56.5,72.20%,20,39,51.3,27.80%,7,15,46.7
Luke Babbitt,MIA ,28,38,30,100%,25,54,46.3,59.3,29.60%,11,16,68.8,70.40%,14,38,36.8
Cody Zeller,CHA ,25,31,24,100%,34,53,64.2,66,94.30%,32,50,64,5.70%,2,3,66.7
Kevon Looney,GSW ,22,52,29,100%,33,53,62.3,63.2,96.20%,32,51,62.7,3.80%,1,2,50
Tyler Zeller,MIL ,28,42,32,100%,32,53,60.4,60.4,96.20%,32,51,62.7,3.80%,0,2,0
Al Jefferson,IND ,33,26,23,100%,24,52,46.2,46.2,96.20%,24,50,48,3.80%,0,2,0
Sterling Brown,MIL ,23,38,27,100%,29,51,56.9,65.7,62.70%,20,32,62.5,37.30%,9,19,47.4
Antonio Blakeney,CHI ,21,18,15,100%,22,51,43.1,51,60.80%,14,31,45.2,39.20%,8,20,40
Ivica Zubac,LAL ,21,36,24,100%,28,50,56,56,98.00%,28,49,57.1,2.00%,0,1,0
Kobi Simmons,MEM ,20,28,20,100%,20,50,40,44,74.00%,16,37,43.2,26.00%,4,13,30.8
Brandon Paul,SAS ,27,54,28,100%,28,49,57.1,62.2,65.30%,23,32,71.9,34.70%,5,17,29.4
Tim Frazier,WAS ,27,49,28,100%,19,49,38.8,41.8,67.30%,16,33,48.5,32.70%,3,16,18.8
Jason Terry,MIL ,40,45,33,100%,12,48,25,32.3,25.00%,5,12,41.7,75.00%,7,36,19.4
Mike Conley,MEM ,30,12,12,100%,23,47,48.9,56.4,53.20%,16,25,64,46.80%,7,22,31.8
Lance Thomas,NYK ,30,45,24,100%,15,46,32.6,41.3,54.30%,7,25,28,45.70%,8,21,38.1
Jahlil Okafor,BKN ,22,20,15,100%,30,45,66.7,67.8,95.60%,29,43,67.4,4.40%,1,2,50
Tarik Black,HOU ,26,42,22,100%,24,45,53.3,53.3,82.20%,24,37,64.9,17.80%,0,8,0
Cameron Payne,CHI ,23,19,19,100%,18,45,40,48.9,44.40%,10,20,50,55.60%,8,25,32
Danilo Gallinari,LAC ,29,18,18,100%,17,45,37.8,44.4,53.30%,11,24,45.8,46.70%,6,21,28.6
Alec Peters,PHX ,23,20,17,100%,15,45,33.3,42.2,24.40%,7,11,63.6,75.60%,8,34,23.5
Marcin Gortat,WAS ,34,46,27,100%,23,43,53.5,53.5,100%,23,43,53.5,0.00%,0,0,-
Matthew Dellavedova,MIL ,27,34,24,100%,22,43,51.2,67.4,32.60%,8,14,57.1,67.40%,14,29,48.3
Troy Williams,NYK ,23,21,17,100%,19,43,44.2,47.7,55.80%,16,24,66.7,44.20%,3,19,15.8
C.J. Williams,LAC ,28,33,23,100%,18,43,41.9,46.5,55.80%,14,24,58.3,44.20%,4,19,21.1
Rodney Purvis,ORL ,24,15,13,100%,15,43,34.9,40.7,55.80%,10,24,41.7,44.20%,5,19,26.3
Tyler Cavanaugh,ATL ,24,30,20,100%,22,42,52.4,65.5,45.20%,11,19,57.9,54.80%,11,23,47.8
Robin Lopez,CHI ,30,25,20,100%,19,42,45.2,45.2,97.60%,19,41,46.3,2.40%,0,1,0
Ramon Sessions,WAS ,32,25,21,100%,18,42,42.9,46.4,76.20%,15,32,46.9,23.80%,3,10,30
Jonas Valanciunas,TOR ,26,37,23,100%,24,41,58.5,58.5,97.60%,24,40,60,2.40%,0,1,0
Aron Baynes,BOS ,31,38,24,100%,23,41,56.1,56.1,95.10%,23,39,59,4.90%,0,2,0
Amir Johnson,PHI ,31,55,28,100%,20,40,50,50,90.00%,20,36,55.6,10.00%,0,4,0
Terrence Ross,ORL ,27,19,16,100%,18,40,45,56.3,45.00%,9,18,50,55.00%,9,22,40.9
Chris McCullough,WAS ,23,18,16,100%,17,40,42.5,43.8,80.00%,16,32,50,20.00%,1,8,12.5
Bobby Brown,HOU ,33,19,18,100%,14,40,35,45,30.00%,6,12,50,70.00%,8,28,28.6
Tristan Thompson,CLE ,27,38,23,100%,27,39,69.2,69.2,100%,27,39,69.2,0.00%,0,0,-
Ekpe Udoh,UTA ,31,55,25,100%,25,39,64.1,64.1,100%,25,39,64.1,0.00%,0,0,-
Danuel House,PHX ,24,20,16,100%,24,39,61.5,66.7,64.10%,20,25,80,35.90%,4,14,28.6
Luke Kornet,NYK ,22,17,17,100%,19,39,48.7,59,38.50%,11,15,73.3,61.50%,8,24,33.3
Derrick Rose,MIN ,29,16,13,100%,17,39,43.6,43.6,82.10%,17,32,53.1,17.90%,0,7,0
Kyle Collinsworth,DAL ,26,30,16,100%,14,38,36.8,36.8,81.60%,14,31,45.2,18.40%,0,7,0
Alex Caruso,LAL ,24,30,19,100%,18,37,48.6,55.4,62.20%,13,23,56.5,37.80%,5,14,35.7
Isaiah Whitehead,BKN ,23,13,12,100%,15,37,40.5,44.6,75.70%,12,28,42.9,24.30%,3,9,33.3
Shaquille Harrison,PHX ,24,22,14,100%,23,36,63.9,66.7,80.60%,21,29,72.4,19.40%,2,7,28.6
MarShon Brooks,MEM ,29,7,7,100%,18,36,50,65.3,55.60%,7,20,35,44.40%,11,16,68.8
Jordan Bell,GSW ,23,41,22,100%,24,35,68.6,68.6,91.40%,24,32,75,8.60%,0,3,0
Ivan Rabb,MEM ,21,30,18,100%,19,35,54.3,54.3,100%,19,35,54.3,0.00%,0,0,-
Eric Moreland,DET ,26,48,17,100%,19,35,54.3,54.3,100%,19,35,54.3,0.00%,0,0,-
Aaron Brooks,MIN ,33,29,19,100%,16,35,45.7,55.7,51.40%,9,18,50,48.60%,7,17,41.2
OG Anunoby,TOR ,20,31,21,100%,16,35,45.7,58.6,25.70%,7,9,77.8,74.30%,9,26,34.6
Juancho Hernangomez,DEN ,22,22,14,100%,14,35,40,50,34.30%,7,12,58.3,65.70%,7,23,30.4
Davon Reed,PHX ,22,20,15,100%,12,35,34.3,41.4,51.40%,7,18,38.9,48.60%,5,17,29.4
Jamel Artis,ORL ,25,13,13,100%,15,34,44.1,48.5,73.50%,12,25,48,26.50%,3,9,33.3
Chandler Parsons,MEM ,29,26,18,100%,12,34,35.3,41.2,47.10%,8,16,50,52.90%,4,18,22.2
JaVale McGee,GSW ,30,24,17,100%,17,33,51.5,51.5,84.80%,17,28,60.7,15.20%,0,5,0
Isaiah Canaan,PHX ,27,17,14,100%,17,33,51.5,62.1,45.50%,10,15,66.7,54.50%,7,18,38.9
Lucas Nogueira,TOR ,25,30,19,100%,19,32,59.4,64.1,71.90%,16,23,69.6,28.10%,3,9,33.3
Malachi Richardson,TOR ,22,19,15,100%,14,32,43.8,53.1,59.40%,8,19,42.1,40.60%,6,13,46.2
Jonathan Isaac,ORL ,20,23,16,100%,13,32,40.6,45.3,75.00%,10,24,41.7,25.00%,3,8,37.5
Jake Layman,POR ,24,29,13,100%,12,32,37.5,43.8,50.00%,8,16,50,50.00%,4,16,25
John Holland,CLE ,29,22,16,100%,8,31,25.8,35.5,29.00%,2,9,22.2,71.00%,6,22,27.3
Torrey Craig,DEN ,27,35,15,100%,14,30,46.7,51.7,66.70%,11,20,55,33.30%,3,10,30
Myke Henry,MEM ,25,20,11,100%,12,30,40,51.7,36.70%,5,11,45.5,63.30%,7,19,36.8
Tony Allen,NOP ,36,16,13,100%,20,29,69,69,100%,20,29,69,0.00%,0,0,-
Ante Zizic,CLE ,21,28,17,100%,20,29,69,69,100%,20,29,69,0.00%,0,0,-
Damion Lee,ATL ,25,15,13,100%,15,29,51.7,55.2,69.00%,13,20,65,31.00%,2,9,22.2
DeAndre' Bembry,ATL ,23,22,17,100%,13,29,44.8,50,69.00%,10,20,50,31.00%,3,9,33.3
Jared Dudley,PHX ,32,34,16,100%,12,29,41.4,53.4,27.60%,5,8,62.5,72.40%,7,21,33.3
Milton Doyle,BKN ,24,10,10,100%,10,29,34.5,41.4,44.80%,6,13,46.2,55.20%,4,16,25
Jose Calderon,CLE ,36,42,18,100%,17,28,60.7,69.6,64.30%,12,18,66.7,35.70%,5,10,50
Jalen Jones,DAL ,25,15,12,100%,13,28,46.4,57.1,53.60%,7,15,46.7,46.40%,6,13,46.2
DeAndre Liggins,NOP ,30,45,21,100%,11,28,39.3,48.2,50.00%,6,14,42.9,50.00%,5,14,35.7
Kay Felder,DET ,23,15,14,100%,5,28,17.9,19.6,64.30%,4,18,22.2,35.70%,1,10,10
Nene,HOU ,35,29,18,100%,15,27,55.6,55.6,96.30%,15,26,57.7,3.70%,0,1,0
Tyrone Wallace,LAC ,23,29,14,100%,17,26,65.4,69.2,88.50%,15,23,65.2,11.50%,2,3,66.7
Miles Plumlee,ATL ,29,34,19,100%,16,26,61.5,61.5,100%,16,26,61.5,0.00%,0,0,-
Dante Exum,UTA ,22,14,12,100%,14,26,53.8,53.8,84.60%,14,22,63.6,15.40%,0,4,0
Tyson Chandler,PHX ,35,34,16,100%,14,26,53.8,53.8,100%,14,26,53.8,0.00%,0,0,-
Marcus Georges-Hunt,MIN ,24,33,13,100%,13,26,50,53.8,69.20%,11,18,61.1,30.80%,2,8,25
Markelle Fultz,PHI ,20,14,13,100%,10,26,38.5,38.5,100%,10,26,38.5,0.00%,0,0,-
Brice Johnson,MEM ,23,17,12,100%,14,25,56,56,96.00%,14,24,58.3,4.00%,0,1,0
Kenneth Faried,DEN ,28,19,13,100%,10,25,40,40,100%,10,25,40,0.00%,0,0,-
Gary Payton II,LAL ,25,15,10,100%,8,25,32,38,64.00%,5,16,31.3,36.00%,3,9,33.3
Rodney McGruder,MIA ,26,14,11,100%,15,24,62.5,72.9,54.20%,10,13,76.9,45.80%,5,11,45.5
Jordan Mickey,MIA ,23,19,14,100%,10,24,41.7,43.8,75.00%,9,18,50,25.00%,1,6,16.7
Brandon Jennings,MIL ,28,12,10,100%,9,24,37.5,41.7,54.20%,7,13,53.8,45.80%,2,11,18.2
Meyers Leonard,POR ,26,18,9,100%,17,23,73.9,84.8,73.90%,12,17,70.6,26.10%,5,6,83.3
Georgios Papagiannis,POR ,20,14,9,100%,10,23,43.5,43.5,100%,10,23,43.5,0.00%,0,0,-
Travis Wear,LAL ,27,16,12,100%,7,23,30.4,39.1,47.80%,3,11,27.3,52.20%,4,12,33.3
Zhou Qi,HOU ,22,18,13,100%,5,23,21.7,26.1,39.10%,3,9,33.3,60.90%,2,14,14.3
Damien Wilkins,IND ,38,19,14,100%,5,23,21.7,21.7,56.50%,5,13,38.5,43.50%,0,10,0
Johnathan Motley,DAL ,23,10,9,100%,11,22,50,52.3,81.80%,10,18,55.6,18.20%,1,4,25
Caleb Swanigan,POR ,21,21,11,100%,10,22,45.5,47.7,81.80%,9,18,50,18.20%,1,4,25
Lorenzo Brown,TOR ,27,11,8,100%,10,22,45.5,47.7,63.60%,9,14,64.3,36.40%,1,8,12.5
Ryan Arcidiacono,CHI ,24,20,13,100%,9,22,40.9,52.3,27.30%,4,6,66.7,72.70%,5,16,31.3
Guerschon Yabusele,BOS ,22,23,16,100%,8,22,36.4,40.9,36.40%,6,8,75,63.60%,2,14,14.3
Willie Reed,DET ,28,25,13,100%,18,21,85.7,85.7,100%,18,21,85.7,0.00%,0,0,-
Timofey Mozgov,BKN ,31,16,12,100%,13,21,61.9,64.3,81.00%,12,17,70.6,19.00%,1,4,25
Furkan Korkmaz,PHI ,20,14,10,100%,6,21,28.6,38.1,38.10%,2,8,25,61.90%,4,13,30.8
Brandan Wright,HOU ,30,21,11,100%,12,20,60,60,100%,12,20,60,0.00%,0,0,-
Patrick Beverley,LAC ,29,9,9,100%,9,20,45,55,55.00%,5,11,45.5,45.00%,4,9,44.4
Alex Poythress,IND ,24,19,13,100%,9,20,45,55,50.00%,5,10,50,50.00%,4,10,40
Glenn Robinson III,IND ,24,18,10,100%,6,20,30,42.5,40.00%,1,8,12.5,60.00%,5,12,41.7
JaKarr Sampson,SAC ,25,18,12,100%,12,19,63.2,68.4,78.90%,10,15,66.7,21.10%,2,4,50
Andre Roberson,OKC ,26,26,13,100%,11,19,57.9,65.8,68.40%,8,13,61.5,31.60%,3,6,50
Isaiah Hicks,NYK ,23,14,9,100%,10,19,52.6,52.6,94.70%,10,18,55.6,5.30%,0,1,0
Quincy Pondexter,CHI ,30,19,8,100%,9,19,47.4,55.3,47.40%,6,9,66.7,52.60%,3,10,30
Rashad Vaughn,ORL ,21,24,11,100%,9,19,47.4,57.9,36.80%,5,7,71.4,63.20%,4,12,33.3
Darrell Arthur,DEN ,30,11,8,100%,8,19,42.1,52.6,47.40%,4,9,44.4,52.60%,4,10,40
Ron Baker,NYK ,25,27,12,100%,5,19,26.3,31.6,63.20%,3,12,25,36.80%,2,7,28.6
Andrew White III,ATL ,24,14,10,100%,5,19,26.3,34.2,21.10%,2,4,50,78.90%,3,15,20
Derrick White,SAS ,23,15,8,100%,9,18,50,69.4,44.40%,2,8,25,55.60%,7,10,70
Iman Shumpert,SAC ,27,10,7,100%,9,18,50,58.3,66.70%,6,12,50,33.30%,3,6,50
Dorian Finney-Smith,DAL ,25,13,7,100%,8,18,44.4,55.6,38.90%,4,7,57.1,61.10%,4,11,36.4
Aaron Harrison,DAL ,23,9,9,100%,6,18,33.3,36.1,38.90%,5,7,71.4,61.10%,1,11,9.1
Larry Drew II,NOP ,28,7,7,100%,5,18,27.8,33.3,72.20%,3,13,23.1,27.80%,2,5,40
Salah Mejri,DAL ,31,31,12,100%,11,17,64.7,64.7,88.20%,11,15,73.3,11.80%,0,2,0
Bruno Caboclo,SAC ,22,10,7,100%,7,17,41.2,47.1,41.20%,5,7,71.4,58.80%,2,10,20
Jonathan Gibson,BOS ,30,4,4,100%,11,16,68.8,84.4,43.80%,6,7,85.7,56.30%,5,9,55.6
Nerlens Noel,DAL ,24,21,10,100%,10,16,62.5,62.5,100%,10,16,62.5,0.00%,0,0,-
Josh Gray,PHX ,24,5,4,100%,4,16,25,28.1,62.50%,3,10,30,37.50%,1,6,16.7
Jamil Wilson,LAC ,27,11,8,100%,3,16,18.8,28.1,18.80%,0,3,0,81.30%,3,13,23.1
Alfonzo McKinnie,TOR ,25,14,7,100%,8,15,53.3,63.3,40.00%,5,6,83.3,60.00%,3,9,33.3
Jordan Crawford,NOP ,29,5,5,100%,6,15,40,53.3,46.70%,2,7,28.6,53.30%,4,8,50
Jeff Withey,DAL ,28,9,9,100%,6,15,40,46.7,33.30%,4,5,80,66.70%,2,10,20
Thomas Bryant,LAL ,20,14,9,100%,6,15,40,43.3,46.70%,5,7,71.4,53.30%,1,8,12.5
Nick Collison,OKC ,37,10,6,100%,10,14,71.4,71.4,100%,10,14,71.4,0.00%,0,0,-
D.J. Wilson,MIL ,22,17,7,100%,9,14,64.3,71.4,78.60%,7,11,63.6,21.40%,2,3,66.7
Derrick Jones Jr.,MIA ,21,13,7,100%,7,14,50,53.6,64.30%,6,9,66.7,35.70%,1,5,20
Xavier Rathan-Mayes,MEM ,24,5,4,100%,6,14,42.9,42.9,64.30%,6,9,66.7,35.70%,0,5,0
Emeka Okafor,NOP ,35,12,10,100%,6,14,42.9,42.9,100%,6,14,42.9,0.00%,0,0,-
Udonis Haslem,MIA ,37,10,8,100%,3,14,21.4,25,42.90%,2,6,33.3,57.10%,1,8,12.5
Dakari Johnson,OKC ,22,22,9,100%,9,13,69.2,69.2,100%,9,13,69.2,0.00%,0,0,-
Richard Jefferson,DEN ,37,18,9,100%,6,13,46.2,53.8,61.50%,4,8,50,38.50%,2,5,40
Cole Aldrich,MIN ,29,20,9,100%,5,13,38.5,38.5,100%,5,13,38.5,0.00%,0,0,-
Gian Clavell,DAL ,24,6,5,100%,5,13,38.5,57.7,7.70%,0,1,0,92.30%,5,12,41.7
Marcus Paige,CHA ,24,5,5,100%,4,13,30.8,38.5,38.50%,2,5,40,61.50%,2,8,25
James Webb III,BKN ,24,9,7,100%,3,13,23.1,30.8,30.80%,1,4,25,69.20%,2,9,22.2
Charles Cooke,NOP ,23,13,9,100%,2,13,15.4,19.2,38.50%,1,5,20,61.50%,1,8,12.5
Damian Jones,GSW ,22,13,5,100%,7,12,58.3,58.3,100%,7,12,58.3,0.00%,0,0,-
Demetrius Jackson,PHI ,23,13,8,100%,6,12,50,54.2,66.70%,5,8,62.5,33.30%,1,4,25
Mirza Teletovic,MIL ,32,6,4,100%,6,12,50,70.8,25.00%,1,3,33.3,75.00%,5,9,55.6
RJ Hunter,HOU ,24,5,3,100%,5,12,41.7,50,33.30%,3,4,75,66.70%,2,8,25
Darrun Hilliard,SAS ,25,11,8,100%,5,12,41.7,41.7,66.70%,5,8,62.5,33.30%,0,4,0
Kadeem Allen,BOS ,25,17,7,100%,5,12,41.7,41.7,58.30%,5,7,71.4,41.70%,0,5,0
Zaza Pachulia,GSW ,34,12,8,100%,7,11,63.6,63.6,100%,7,11,63.6,0.00%,0,0,-
Josh Magette,ATL ,28,16,9,100%,4,11,36.4,45.5,63.60%,2,7,28.6,36.40%,2,4,50
Briante Weber,MEM ,25,17,6,100%,4,11,36.4,50,54.50%,1,6,16.7,45.50%,3,5,60
Malcolm Miller,TOR ,25,10,5,100%,4,11,36.4,45.5,27.30%,2,3,66.7,72.70%,2,8,25
Georges Niang,UTA ,24,9,6,100%,4,10,40,40,60.00%,4,6,66.7,40.00%,0,4,0
Tony Bradley,UTA ,20,9,7,100%,3,10,30,30,90.00%,3,9,33.3,10.00%,0,1,0
Kawhi Leonard,SAS ,26,5,4,100%,5,9,55.6,61.1,77.80%,4,7,57.1,22.20%,1,2,50
Daniel Hamilton,OKC ,22,6,4,100%,4,9,44.4,55.6,44.40%,2,4,50,55.60%,2,5,40
Kyle Singler,OKC ,30,10,6,100%,4,9,44.4,44.4,88.90%,4,8,50,11.10%,0,1,0
Jack Cooley,SAC ,27,7,5,100%,6,8,75,75,100%,6,8,75,0.00%,0,0,-
Jameel Warney,DAL ,24,3,3,100%,5,8,62.5,62.5,100%,5,8,62.5,0.00%,0,0,-
Jabari Bird,BOS ,23,12,4,100%,4,8,50,62.5,62.50%,2,5,40,37.50%,2,3,66.7
Solomon Hill,NOP ,27,7,4,100%,4,8,50,56.3,50.00%,3,4,75,50.00%,1,4,25
Jon Leuer,DET ,29,7,5,100%,3,8,37.5,37.5,100%,3,8,37.5,0.00%,0,0,-
Nigel Hayes,SAC ,23,9,5,100%,3,8,37.5,50,37.50%,1,3,33.3,62.50%,2,5,40
Wade Baldwin IV,POR ,22,7,3,100%,6,7,85.7,85.7,85.70%,6,6,100,14.30%,0,1,0
Adreian Payne,ORL ,27,5,3,100%,4,7,57.1,64.3,71.40%,3,5,60,28.60%,1,2,50
Antonius Cleveland,ATL ,24,10,5,100%,4,7,57.1,64.3,85.70%,3,6,50,14.30%,1,1,100
Ike Anigbogu,IND ,19,11,4,100%,4,7,57.1,57.1,100%,4,7,57.1,0.00%,0,0,-
Mangok Mathiang,CHA ,25,4,2,100%,4,7,57.1,57.1,100%,4,7,57.1,0.00%,0,0,-
Markel Brown,HOU ,26,4,2,100%,2,7,28.6,35.7,28.60%,1,2,50,71.40%,1,5,20
James Michael McAdoo,PHI ,25,3,3,100%,2,7,28.6,42.9,0.00%,0,0,-,100%,2,7,28.6
Derrick Walton Jr.,MIA ,23,12,6,100%,0,7,0,0,85.70%,0,6,0,14.30%,0,1,0
Joakim Noah,NYK ,33,4,3,100%,4,6,66.7,66.7,100%,4,6,66.7,0.00%,0,0,-
James Young,PHI ,22,6,3,100%,2,6,33.3,33.3,50.00%,2,3,66.7,50.00%,0,3,0
Jaylen Morris,ATL ,22,5,4,100%,2,6,33.3,33.3,83.30%,2,5,40,16.70%,0,1,0
Matt Williams Jr.,MIA ,24,3,3,100%,2,6,33.3,41.7,16.70%,1,1,100,83.30%,1,5,20
London Perrantes,CLE ,23,13,6,100%,1,6,16.7,16.7,50.00%,1,3,33.3,50.00%,0,3,0
Omer Asik,CHI ,31,9,2,100%,4,5,80,80,100%,4,5,80,0.00%,0,0,-
Vincent Hunter,MEM ,23,4,3,100%,3,5,60,60,100%,3,5,60,0.00%,0,0,-
Monte Morris,DEN ,22,3,2,100%,3,5,60,60,80.00%,3,4,75,20.00%,0,1,0
Nate Wolters,UTA ,27,5,3,100%,1,5,20,20,100%,1,5,20,0.00%,0,0,-
Xavier Munford,MIL ,25,6,3,100%,0,5,0,0,60.00%,0,3,0,40.00%,0,2,0
Julyan Stone,CHA ,29,22,2,100%,3,4,75,112.5,0.00%,0,0,-,100%,3,4,75
Andre Ingram,LAL ,32,2,1,100%,2,4,50,62.5,50.00%,1,2,50,50.00%,1,2,50
Alan Williams,PHX ,25,4,3,100%,1,4,25,25,100%,1,4,25,0.00%,0,0,-
Matt Costello,SAS ,24,3,3,100%,2,3,66.7,66.7,100%,2,3,66.7,0.00%,0,0,-
David Stockton,UTA ,26,3,2,100%,2,3,66.7,100,0.00%,0,0,-,100%,2,3,66.7
Josh Smith,NOP ,32,2,1,100%,1,3,33.3,33.3,100%,1,3,33.3,0.00%,0,0,-
Marquis Teague,MEM ,25,3,2,100%,1,3,33.3,33.3,100%,1,3,33.3,0.00%,0,0,-
Tim Quarterman,HOU ,23,3,2,100%,1,3,33.3,33.3,33.30%,1,1,100,66.70%,0,2,0
Jacob Wiley,BKN ,23,3,2,100%,1,3,33.3,50,33.30%,0,1,0,66.70%,1,2,50
PJ Dozier,OKC ,21,2,1,100%,1,2,50,50,100%,1,2,50,0.00%,0,0,-
Jacob Pullen,PHI ,28,3,2,100%,1,2,50,50,50.00%,1,1,100,50.00%,0,1,0
Jeremy Lin,BKN ,29,1,1,100%,1,2,50,50,50.00%,1,1,100,50.00%,0,1,0
Justin Patton,MIN ,20,1,1,100%,1,2,50,50,100%,1,2,50,0.00%,0,0,-
Chinanu Onuaku,HOU ,21,1,1,100%,1,2,50,50,100%,1,2,50,0.00%,0,0,-
Reggie Hearn,DET ,26,3,2,100%,1,2,50,75,0.00%,0,0,-,100%,1,2,50
Vander Blue,LAL ,25,3,1,100%,1,2,50,50,100%,1,2,50,0.00%,0,0,-
Nicolas Brussino,ATL ,25,4,2,100%,0,2,0,0,0.00%,0,0,-,100%,0,2,0
Xavier Silas,BOS ,30,2,1,100%,0,2,0,0,50.00%,0,1,0,50.00%,0,1,0
Omari Johnson,MEM ,29,4,2,100%,0,2,0,0,0.00%,0,0,-,100%,0,2,0
Edmond Sumner,IND ,22,1,1,100%,1,1,100,100,100%,1,1,100,0.00%,0,0,-
Naz Mitrou-Long,UTA ,24,1,1,100%,1,1,100,150,0.00%,0,0,-,100%,1,1,100
Jeremy Evans,ATL ,30,1,1,100%,1,1,100,100,100%,1,1,100,0.00%,0,0,-
Anthony Brown,MIN ,25,1,1,100%,1,1,100,150,0.00%,0,0,-,100%,1,1,100
Kendrick Perkins,CLE ,33,1,1,100%,1,1,100,100,100%,1,1,100,0.00%,0,0,-
Marshall Plumlee,MIL ,25,7,1,100%,1,1,100,100,100%,1,1,100,0.00%,0,0,-
Joel Bolomboy,MIL ,24,5,1,100%,1,1,100,100,100%,1,1,100,0.00%,0,0,-
Chris Boucher,GSW ,25,1,1,100%,0,1,0,0,0.00%,0,0,-,100%,0,1,0
Jarell Eddie,CHI ,26,2,1,100%,0,1,0,0,0.00%,0,0,-,100%,0,1,0
Erik McCree,UTA ,24,4,1,100%,0,1,0,0,0.00%,0,0,-,100%,0,1,0
Luis Montero,DET ,25,2,1,100%,0,1,0,0,100%,0,1,0,0.00%,0,0,-
Mindaugas Kuzminskas,NYK ,28,1,1,100%,0,1,0,0,100%,0,1,0,0.00%,0,0,-
