name,team,age,gp,g,fgfreq,fgm,fga,fgp,efgp,2fgfreq,2fgm,2fga,2fgp,3pfreq,3pm,3pa,3pp
Klay Thompson,GSW ,28,17,17,100%,49,97,50.5,61.3,53.60%,28,52,53.8,46.40%,21,45,46.7
James Harden,HOU ,28,17,17,100%,38,92,41.3,48.4,51.10%,25,47,53.2,48.90%,13,45,28.9
LeBron James,CLE ,33,18,18,100%,57,86,66.3,69.2,86.00%,52,74,70.3,14.00%,5,12,41.7
Kevin Durant,GSW ,29,17,17,100%,38,73,52.1,56.8,71.20%,31,52,59.6,28.80%,7,21,33.3
Terry Rozier,BOS ,24,19,19,100%,27,68,39.7,50.7,44.10%,12,30,40,55.90%,15,38,39.5
Chris Paul,HOU ,33,15,15,100%,32,66,48.5,56.1,62.10%,22,41,53.7,37.90%,10,25,40
Eric Gordon,HOU ,29,17,17,100%,27,62,43.5,56.5,40.30%,11,25,44,59.70%,16,37,43.2
Jayson Tatum,BOS ,20,19,19,100%,23,56,41.1,46.4,71.40%,17,40,42.5,28.60%,6,16,37.5
Marcus Morris,BOS ,28,19,18,100%,22,53,41.5,50.9,62.30%,12,33,36.4,37.70%,10,20,50
Kevin Love,CLE ,29,16,14,100%,25,51,49,55.9,62.70%,18,32,56.3,37.30%,7,19,36.8
Anthony Davis,NOP ,25,9,9,100%,27,48,56.3,56.3,95.80%,27,46,58.7,4.20%,0,2,0
Stephen Curry,GSW ,30,11,11,100%,22,48,45.8,51,56.30%,17,27,63,43.80%,5,21,23.8
Al Horford,BOS ,31,19,16,100%,31,46,67.4,71.7,73.90%,27,34,79.4,26.10%,4,12,33.3
Jaylen Brown,BOS ,21,18,16,100%,24,44,54.5,67,43.20%,13,19,68.4,56.80%,11,25,44
Donovan Mitchell,UTA ,21,11,11,100%,18,43,41.9,45.3,60.50%,15,26,57.7,39.50%,3,17,17.6
Jordan Clarkson,CLE ,25,17,16,100%,17,40,42.5,50,62.50%,11,25,44,37.50%,6,15,40
Marcus Smart,BOS ,24,15,15,100%,16,40,40,43.8,52.50%,13,21,61.9,47.50%,3,19,15.8
Joel Embiid,PHI ,24,8,8,100%,17,39,43.6,46.2,79.50%,15,31,48.4,20.50%,2,8,25
Kyle Korver,CLE ,37,16,14,100%,22,38,57.9,75,36.80%,9,14,64.3,63.20%,13,24,54.2
Jeff Green,CLE ,31,18,15,100%,20,38,52.6,59.2,57.90%,15,22,68.2,42.10%,5,16,31.3
Nikola Mirotic,NOP ,27,9,9,100%,19,38,50,60.5,60.50%,11,23,47.8,39.50%,8,15,53.3
Russell Westbrook,OKC ,29,6,6,100%,15,37,40.5,40.5,83.80%,15,31,48.4,16.20%,0,6,0
Clint Capela,HOU ,24,17,12,100%,28,36,77.8,77.8,100%,28,36,77.8,0.00%,0,0,-
PJ Tucker,HOU ,33,17,14,100%,22,36,61.1,80.6,25.00%,8,9,88.9,75.00%,14,27,51.9
DeMar DeRozan,TOR ,28,10,10,100%,16,33,48.5,51.5,87.90%,14,29,48.3,12.10%,2,4,50
Draymond Green,GSW ,28,17,14,100%,14,33,42.4,47,48.50%,11,16,68.8,51.50%,3,17,17.6
Jrue Holiday,NOP ,27,9,9,100%,17,32,53.1,59.4,68.80%,13,22,59.1,31.30%,4,10,40
Trevor Ariza,HOU ,32,17,14,100%,14,32,43.8,53.1,43.80%,8,14,57.1,56.30%,6,18,33.3
Joe Ingles,UTA ,30,11,11,100%,13,31,41.9,58.1,29.00%,3,9,33.3,71.00%,10,22,45.5
Khris Middleton,MIL ,26,7,7,100%,21,30,70,78.3,73.30%,16,22,72.7,26.70%,5,8,62.5
Shaun Livingston,GSW ,32,17,15,100%,18,30,60,60,100%,18,30,60,0.00%,0,0,-
Dario Saric,PHI ,24,10,9,100%,15,30,50,60,56.70%,9,17,52.9,43.30%,6,13,46.2
JR Smith,CLE ,32,18,13,100%,11,30,36.7,48.3,40.00%,4,12,33.3,60.00%,7,18,38.9
Aron Baynes,BOS ,31,18,14,100%,15,29,51.7,56.9,69.00%,12,20,60,31.00%,3,9,33.3
Marco Belinelli,PHI ,32,10,10,100%,8,29,27.6,32.8,48.30%,5,14,35.7,51.70%,3,15,20
Lance Stephenson,IND ,27,7,7,100%,14,27,51.9,55.6,66.70%,12,18,66.7,33.30%,2,9,22.2
JJ Redick,PHI ,33,10,10,100%,12,27,44.4,55.6,37.00%,6,10,60,63.00%,6,17,35.3
Jae Crowder,UTA ,27,9,9,100%,7,27,25.9,35.2,37.00%,2,10,20,63.00%,5,17,29.4
Giannis Antetokounmpo,MIL ,23,7,7,100%,19,26,73.1,76.9,88.50%,17,23,73.9,11.50%,2,3,66.7
Kyle Lowry,TOR ,32,10,10,100%,12,26,46.2,59.6,30.80%,5,8,62.5,69.20%,7,18,38.9
Ricky Rubio,UTA ,27,5,5,100%,10,26,38.5,44.2,53.80%,7,14,50,46.20%,3,12,25
Jonas Valanciunas,TOR ,26,10,9,100%,17,25,68,70,88.00%,16,22,72.7,12.00%,1,3,33.3
Ben Simmons,PHI ,21,10,9,100%,12,25,48,48,96.00%,12,24,50,4.00%,0,1,0
Derrick Rose,MIN ,29,5,5,100%,16,24,66.7,72.9,83.30%,13,20,65,16.70%,3,4,75
Rajon Rondo,NOP ,32,9,9,100%,11,24,45.8,54.2,70.80%,7,17,41.2,29.20%,4,7,57.1
Paul George,OKC ,28,6,6,100%,9,24,37.5,43.8,54.20%,6,13,46.2,45.80%,3,11,27.3
Ersan Ilyasova,PHI ,31,10,10,100%,9,24,37.5,43.8,66.70%,6,16,37.5,33.30%,3,8,37.5
CJ Miles,TOR ,31,10,8,100%,13,23,56.5,73.9,30.40%,5,7,71.4,69.60%,8,16,50
Bradley Beal,WAS ,24,6,6,100%,11,23,47.8,56.5,69.60%,7,16,43.8,30.40%,4,7,57.1
Dwyane Wade,MIA ,36,5,5,100%,9,23,39.1,39.1,95.70%,9,22,40.9,4.30%,0,1,0
John Wall,WAS ,27,6,6,100%,12,22,54.5,54.5,81.80%,12,18,66.7,18.20%,0,4,0
Delon Wright,TOR ,26,10,9,100%,9,21,42.9,50,81.00%,6,17,35.3,19.00%,3,4,75
Royce O'Neale,UTA ,24,11,8,100%,13,20,65,77.5,45.00%,8,9,88.9,55.00%,5,11,45.5
Rudy Gay,SAS ,31,5,5,100%,12,20,60,67.5,75.00%,9,15,60,25.00%,3,5,60
Jabari Parker,MIL ,23,6,6,100%,12,20,60,65,80.00%,10,16,62.5,20.00%,2,4,50
Karl-Anthony Towns,MIN ,22,5,4,100%,9,20,45,45,80.00%,9,16,56.3,20.00%,0,4,0
Gerald Green,HOU ,32,16,12,100%,8,20,40,57.5,15.00%,1,3,33.3,85.00%,7,17,41.2
Victor Oladipo,IND ,26,7,7,100%,11,19,57.9,73.7,47.40%,5,9,55.6,52.60%,6,10,60
Tony Parker,SAS ,36,5,5,100%,7,19,36.8,36.8,89.50%,7,17,41.2,10.50%,0,2,0
Rudy Gobert,UTA ,25,11,9,100%,14,18,77.8,77.8,100%,14,18,77.8,0.00%,0,0,-
Alec Burks,UTA ,26,6,4,100%,10,18,55.6,61.1,77.80%,8,14,57.1,22.20%,2,4,50
Eric Bledsoe,MIL ,28,7,7,100%,10,18,55.6,61.1,83.30%,8,15,53.3,16.70%,2,3,66.7
Andre Iguodala,GSW ,34,13,13,100%,9,18,50,55.6,55.60%,7,10,70,44.40%,2,8,25
Carmelo Anthony,OKC ,33,6,6,100%,8,18,44.4,44.4,77.80%,8,14,57.1,22.20%,0,4,0
Domantas Sabonis,IND ,22,7,6,100%,11,17,64.7,64.7,88.20%,11,15,73.3,11.80%,0,2,0
Larry Nance Jr.,CLE ,25,13,9,100%,10,17,58.8,58.8,100%,10,17,58.8,0.00%,0,0,-
CJ McCollum,POR ,26,4,4,100%,10,17,58.8,67.6,64.70%,7,11,63.6,35.30%,3,6,50
David West,GSW ,37,13,10,100%,10,17,58.8,58.8,94.10%,10,16,62.5,5.90%,0,1,0
Tristan Thompson,CLE ,27,11,8,100%,10,16,62.5,62.5,93.80%,10,15,66.7,6.30%,0,1,0
Jimmy Butler,MIN ,28,5,5,100%,9,16,56.3,62.5,81.30%,7,13,53.8,18.80%,2,3,66.7
Rodney Hood,CLE ,25,12,8,100%,9,16,56.3,59.4,75.00%,8,12,66.7,25.00%,1,4,25
Bojan Bogdanovic,IND ,29,7,7,100%,7,16,43.8,56.3,50.00%,3,8,37.5,50.00%,4,8,50
George Hill,CLE ,32,14,10,100%,6,16,37.5,40.6,56.30%,5,9,55.6,43.80%,1,7,14.3
Goran Dragic,MIA ,32,5,5,100%,11,15,73.3,76.7,86.70%,10,13,76.9,13.30%,1,2,50
Al-Farouq Aminu,POR ,27,4,4,100%,9,15,60,76.7,46.70%,4,7,57.1,53.30%,5,8,62.5
Darren Collison,IND ,30,7,7,100%,8,15,53.3,60,66.70%,6,10,60,33.30%,2,5,40
Cory Joseph,IND ,26,7,7,100%,7,15,46.7,53.3,53.30%,5,8,62.5,46.70%,2,7,28.6
Robert Covington,PHI ,27,10,8,100%,6,15,40,50,46.70%,3,7,42.9,53.30%,3,8,37.5
E'Twaun Moore,NOP ,29,9,7,100%,9,14,64.3,71.4,64.30%,7,9,77.8,35.70%,2,5,40
Jamal Crawford,MIN ,38,5,5,100%,8,14,57.1,71.4,57.10%,4,8,50,42.90%,4,6,66.7
Kelly Olynyk,MIA ,27,5,5,100%,5,14,35.7,39.3,71.40%,4,10,40,28.60%,1,4,25
Damian Lillard,POR ,27,4,4,100%,3,14,21.4,21.4,64.30%,3,9,33.3,35.70%,0,5,0
OG Anunoby,TOR ,20,10,8,100%,8,13,61.5,73.1,61.50%,5,8,62.5,38.50%,3,5,60
Justise Winslow,MIA ,22,5,5,100%,8,13,61.5,73.1,61.50%,5,8,62.5,38.50%,3,5,60
Fred VanVleet,TOR ,24,6,6,100%,7,13,53.8,69.2,30.80%,3,4,75,69.20%,4,9,44.4
Serge Ibaka,TOR ,28,10,5,100%,6,13,46.2,57.7,46.20%,3,6,50,53.80%,3,7,42.9
Mike Scott,WAS ,29,5,4,100%,10,12,83.3,87.5,91.70%,9,11,81.8,8.30%,1,1,100
Kevon Looney,GSW ,22,15,7,100%,6,12,50,50,100%,6,12,50,0.00%,0,0,-
Corey Brewer,OKC ,32,6,4,100%,5,12,41.7,45.8,66.70%,4,8,50,33.30%,1,4,25
Jonas Jerebko,UTA ,31,10,3,100%,5,12,41.7,45.8,66.70%,4,8,50,33.30%,1,4,25
LaMarcus Aldridge,SAS ,32,5,5,100%,4,12,33.3,33.3,100%,4,12,33.3,0.00%,0,0,-
Patty Mills,SAS ,29,5,5,100%,4,12,33.3,45.8,16.70%,1,2,50,83.30%,3,10,30
Myles Turner,IND ,22,7,5,100%,9,11,81.8,95.5,72.70%,6,8,75,27.30%,3,3,100
Darius Miller,NOP ,28,9,6,100%,6,11,54.5,72.7,36.40%,2,4,50,63.60%,4,7,57.1
Quinn Cook,GSW ,25,10,7,100%,6,11,54.5,54.5,72.70%,6,8,75,27.30%,0,3,0
Ian Clark,NOP ,27,9,8,100%,4,11,36.4,45.5,45.50%,2,5,40,54.50%,2,6,33.3
Wayne Ellington,MIA ,30,5,5,100%,3,11,27.3,40.9,9.10%,0,1,0,90.90%,3,10,30
Pascal Siakam,TOR ,24,10,9,100%,7,10,70,70,100%,7,10,70,0.00%,0,0,-
Otto Porter Jr.,WAS ,24,5,4,100%,5,10,50,50,70.00%,5,7,71.4,30.00%,0,3,0
Jeff Teague,MIN ,29,4,4,100%,5,10,50,55,70.00%,4,7,57.1,30.00%,1,3,33.3
Malcolm Brogdon,MIL ,25,7,5,100%,2,10,20,25,40.00%,1,4,25,60.00%,1,6,16.7
Markieff Morris,WAS ,28,6,6,100%,7,9,77.8,83.3,77.80%,6,7,85.7,22.20%,1,2,50
T.J. McConnell,PHI ,26,9,6,100%,6,9,66.7,66.7,100%,6,9,66.7,0.00%,0,0,-
Thaddeus Young,IND ,29,7,6,100%,5,9,55.6,55.6,88.90%,5,8,62.5,11.10%,0,1,0
Greg Monroe,BOS ,27,7,4,100%,5,9,55.6,55.6,100%,5,9,55.6,0.00%,0,0,-
Derrick Favors,UTA ,26,11,7,100%,5,9,55.6,55.6,88.90%,5,8,62.5,11.10%,0,1,0
Pau Gasol,SAS ,37,5,5,100%,4,9,44.4,44.4,88.90%,4,8,50,11.10%,0,1,0
Steven Adams,OKC ,24,6,5,100%,4,9,44.4,44.4,100%,4,9,44.4,0.00%,0,0,-
Kelly Oubre Jr.,WAS ,22,6,5,100%,3,9,33.3,38.9,44.40%,2,4,50,55.60%,1,5,20
Bam Adebayo,MIA ,20,5,4,100%,3,9,33.3,33.3,100%,3,9,33.3,0.00%,0,0,-
Ian Mahinmi,WAS ,31,5,5,100%,7,8,87.5,87.5,100%,7,8,87.5,0.00%,0,0,-
Zach Collins,POR ,20,3,3,100%,4,8,50,56.3,62.50%,3,5,60,37.50%,1,3,33.3
Dante Exum,UTA ,22,8,4,100%,3,8,37.5,37.5,75.00%,3,6,50,25.00%,0,2,0
Evan Turner,POR ,29,3,3,100%,3,8,37.5,43.8,50.00%,2,4,50,50.00%,1,4,25
Raymond Felton,OKC ,33,6,6,100%,2,8,25,37.5,37.50%,0,3,0,62.50%,2,5,40
Danny Green,SAS ,30,5,4,100%,2,8,25,31.3,50.00%,1,4,25,50.00%,1,4,25
Tony Snell,MIL ,26,6,3,100%,2,8,25,37.5,0.00%,0,0,-,100%,2,8,25
Luc Mbah a Moute,HOU ,31,7,6,100%,2,8,25,25,62.50%,2,5,40,37.50%,0,3,0
Marcin Gortat,WAS ,34,5,3,100%,7,7,100,100,100%,7,7,100,0.00%,0,0,-
Jakob Poeltl,TOR ,22,8,5,100%,7,7,100,100,100%,7,7,100,0.00%,0,0,-
James Johnson,MIA ,31,5,3,100%,5,7,71.4,78.6,85.70%,4,6,66.7,14.30%,1,1,100
Nick Young,GSW ,32,10,4,100%,4,7,57.1,78.6,14.30%,1,1,100,85.70%,3,6,50
Shane Larkin,BOS ,25,10,7,100%,3,7,42.9,42.9,85.70%,3,6,50,14.30%,0,1,0
Tomas Satoransky,WAS ,26,6,5,100%,1,7,14.3,14.3,85.70%,1,6,16.7,14.30%,0,1,0
Jusuf Nurkic,POR ,23,3,2,100%,4,6,66.7,66.7,100%,4,6,66.7,0.00%,0,0,-
Pat Connaughton,POR ,25,4,3,100%,3,6,50,58.3,33.30%,2,2,100,66.70%,1,4,25
Josh Richardson,MIA ,24,5,3,100%,2,6,33.3,41.7,33.30%,1,2,50,66.70%,1,4,25
Shabazz Napier,POR ,26,2,2,100%,2,6,33.3,33.3,50.00%,2,3,66.7,50.00%,0,3,0
Thon Maker,MIL ,21,5,3,100%,2,6,33.3,50,33.30%,0,2,0,66.70%,2,4,50
Manu Ginobili,SAS ,40,5,3,100%,1,6,16.7,25,0.00%,0,0,-,100%,1,6,16.7
Andrew Wiggins,MIN ,23,5,3,100%,1,6,16.7,16.7,50.00%,1,3,33.3,50.00%,0,3,0
Raul Neto,UTA ,26,4,3,100%,0,6,0,0,66.70%,0,4,0,33.30%,0,2,0
Davis Bertans,SAS ,25,5,5,100%,0,6,0,0,16.70%,0,1,0,83.30%,0,5,0
Dejounte Murray,SAS ,21,3,2,100%,4,5,80,100,60.00%,2,3,66.7,40.00%,2,2,100
Amir Johnson,PHI ,31,7,3,100%,4,5,80,80,100%,4,5,80,0.00%,0,0,-
Jerami Grant,OKC ,24,6,2,100%,3,5,60,60,80.00%,3,4,75,20.00%,0,1,0
JaVale McGee,GSW ,30,5,4,100%,3,5,60,60,100%,3,5,60,0.00%,0,0,-
Ty Lawson,WAS ,30,5,3,100%,2,5,40,40,60.00%,2,3,66.7,40.00%,0,2,0
Matthew Dellavedova,MIL ,27,6,4,100%,1,5,20,30,0.00%,0,0,-,100%,1,5,20
Solomon Hill,NOP ,27,9,4,100%,1,5,20,30,20.00%,0,1,0,80.00%,1,4,25
Norman Powell,TOR ,25,4,4,100%,1,5,20,30,40.00%,0,2,0,60.00%,1,3,33.3
Kyle Anderson,SAS ,24,4,3,100%,3,4,75,75,75.00%,3,3,100,25.00%,0,1,0
Hassan Whiteside,MIA ,28,5,2,100%,3,4,75,75,100%,3,4,75,0.00%,0,0,-
Shabazz Muhammad,MIL ,25,1,1,100%,3,4,75,87.5,75.00%,2,3,66.7,25.00%,1,1,100
Semi Ojeleye,BOS ,23,14,4,100%,2,4,50,75,0.00%,0,0,-,100%,2,4,50
Taj Gibson,MIN ,32,4,3,100%,2,4,50,50,100%,2,4,50,0.00%,0,0,-
Justin Anderson,PHI ,24,4,2,100%,1,4,25,37.5,0.00%,0,0,-,100%,1,4,25
Trevor Booker,IND ,30,7,3,100%,3,3,100,100,100%,3,3,100,0.00%,0,0,-
Ed Davis,POR ,28,4,2,100%,3,3,100,100,100%,3,3,100,0.00%,0,0,-
Nene,HOU ,35,7,3,100%,3,3,100,100,100%,3,3,100,0.00%,0,0,-
Maurice Harkless,POR ,25,2,2,100%,1,3,33.3,33.3,66.70%,1,2,50,33.30%,0,1,0
Cedi Osman,CLE ,23,3,1,100%,1,3,33.3,33.3,66.70%,1,2,50,33.30%,0,1,0
Alex Abrines,OKC ,24,6,2,100%,1,3,33.3,50,0.00%,0,0,-,100%,1,3,33.3
Tyler Johnson,MIA ,26,3,2,100%,2,2,100,125,50.00%,1,1,100,50.00%,1,1,100
John Henson,MIL ,27,2,2,100%,1,2,50,50,100%,1,2,50,0.00%,0,0,-
Jose Calderon,CLE ,36,3,2,100%,0,2,0,0,0.00%,0,0,-,100%,0,2,0
Ryan Anderson,HOU ,30,7,2,100%,0,2,0,0,50.00%,0,1,0,50.00%,0,1,0
Tyler Zeller,MIL ,28,4,1,100%,1,1,100,100,100%,1,1,100,0.00%,0,0,-
Cheick Diallo,NOP ,21,1,1,100%,1,1,100,100,100%,1,1,100,0.00%,0,0,-
Jason Terry,MIL ,40,2,1,100%,1,1,100,150,0.00%,0,0,-,100%,1,1,100
Joe Johnson,HOU ,36,3,1,100%,1,1,100,100,100%,1,1,100,0.00%,0,0,-
Tim Frazier,WAS ,27,1,1,100%,0,1,0,0,100%,0,1,0,0.00%,0,0,-
Josh Huestis,OKC ,26,2,1,100%,0,1,0,0,100%,0,1,0,0.00%,0,0,-
Patrick Patterson,OKC ,29,6,1,100%,0,1,0,0,0.00%,0,0,-,100%,0,1,0
Gorgui Dieng,MIN ,28,4,1,100%,0,1,0,0,100%,0,1,0,0.00%,0,0,-
Guerschon Yabusele,BOS ,22,3,1,100%,0,1,0,0,0.00%,0,0,-,100%,0,1,0
Rodney McGruder,MIA ,26,2,1,100%,0,1,0,0,0.00%,0,0,-,100%,0,1,0
